Obec;Celkem;MCelkem;ZCelkem;PV;MPV;ZPV
554782;1324277;647286;676991;41.9388;40.4911;43.3230
529303;16758;8024;8734;42.8968;41.1965;44.4589
532568;234;112;122;44.6325;47.7232;41.7951
530743;218;108;110;43.5229;43.7130;43.3364
532380;111;54;57;48.4099;45.4815;51.1842
532096;86;41;45;43.8721;40.8659;46.6111
532924;773;387;386;40.3784;40.8953;39.8601
529451;4483;2235;2248;41.5065;40.3174;42.6886
532690;150;79;71;36.4133;36.3608;36.4718
529478;125;66;59;40.5240;38.9848;42.2458
529486;1393;675;718;43.2674;41.7889;44.6574
529516;2917;1453;1464;41.4256;40.7512;42.0949
529532;349;173;176;41.0817;40.4827;41.6705
529541;166;80;86;43.5843;44.1125;43.0930
529567;721;348;373;40.5957;40.0632;41.0925
532746;63;32;31;43.7698;43.5000;44.0484
529621;1758;881;877;40.5233;38.8564;42.1978
529648;881;440;441;44.7656;43.2659;46.2619
532151;103;55;48;37.0146;32.3182;42.3958
532843;63;35;28;42.9286;39.2143;47.5714
529702;728;368;360;42.9863;42.8832;43.0917
532932;23;15;8;53.4130;49.1667;61.3750
529737;298;144;154;44.0940;44.6736;43.5519
529745;334;170;164;42.1048;41.5235;42.7073
532886;217;109;108;36.5461;35.7202;37.3796
532878;51;30;21;49.8922;48.7667;51.5000
532045;377;192;185;39.6088;39.4063;39.8189
529770;129;68;61;44.3760;44.6912;44.0246
529788;148;82;66;39.5135;37.2683;42.3030
529796;1266;629;637;41.1556;40.6606;41.6444
532606;72;37;35;45.0694;41.2297;49.1286
529818;585;292;293;39.4675;39.2774;39.6570
532037;235;116;119;41.3511;40.2500;42.4244
529842;911;422;489;43.1619;41.5474;44.5552
529851;121;64;57;44.9711;44.7656;45.2018
532134;127;63;64;43.2874;42.1190;44.4375
531031;140;72;68;49.1929;47.6944;50.7794
529907;183;94;89;45.1448;43.0319;47.3764
533084;271;153;118;41.5996;39.9379;43.7542
529931;514;248;266;40.0739;40.7742;39.4211
529940;325;149;176;40.0846;38.7013;41.2557
529958;1051;536;515;41.3516;39.9123;42.8495
529974;454;241;213;43.9978;42.2967;45.9225
529991;807;394;413;41.9399;40.6421;43.1780
530000;434;226;208;43.0138;42.4513;43.6250
530026;94;48;46;41.4894;39.3542;43.7174
530051;796;400;396;40.2814;39.1875;41.3864
530069;208;107;101;40.6971;41.0327;40.3416
532258;66;33;33;44.1364;43.6515;44.6212
530093;580;294;286;41.4345;40.0986;42.8077
530107;658;327;331;44.2857;43.9404;44.6269
532193;426;220;206;43.6995;42.2273;45.2718
530115;754;387;367;42.7825;41.9005;43.7125
530158;366;187;179;42.7049;41.3503;44.1201
530166;821;404;417;45.6839;44.4208;46.9077
530174;192;106;86;39.6302;38.4340;41.1047
530191;213;112;101;46.1009;42.7946;49.7673
530204;855;417;438;41.4673;40.6343;42.2603
530212;1059;547;512;43.9353;43.4653;44.4375
530263;755;373;382;41.1795;41.3713;40.9921
530298;1157;577;580;41.4922;40.7964;42.1845
530301;536;291;245;41.6045;42.0430;41.0837
530310;2661;1359;1302;41.4684;40.9518;42.0077
530344;1287;656;631;41.3827;40.4497;42.3526
599395;52;29;23;41.7308;40.4310;43.3696
530352;399;196;203;40.9837;39.9643;41.9680
533076;249;117;132;39.4518;37.5342;41.1515
530409;316;156;160;41.5728;39.9679;43.1375
532649;277;132;145;44.4531;45.0985;43.8655
530441;1364;685;679;40.2852;38.1263;42.4632
530450;1363;702;661;41.4589;40.4601;42.5197
530476;569;292;277;41.8972;40.1233;43.7671
530492;390;186;204;39.8615;41.0538;38.7745
530514;127;69;58;45.3583;41.9348;49.4310
538680;2021;982;1039;39.1734;38.2240;40.0707
530522;266;130;136;47.6880;47.1231;48.2279
530531;385;195;190;40.0974;40.8436;39.3316
530549;167;83;84;43.0569;41.7289;44.3690
532550;303;154;149;41.0611;39.1753;43.0101
538710;442;221;221;44.7195;44.5769;44.8620
532941;236;130;106;40.0847;38.6000;41.9057
534382;3734;1851;1883;44.4068;42.8042;45.9822
532231;36;20;16;42.1944;38.6000;46.6875
530611;269;138;131;46.9647;44.1449;49.9351
532436;112;61;51;41.7500;42.4672;40.8922
530638;410;209;201;39.3829;37.9402;40.8831
599387;246;116;130;46.7276;46.8621;46.6077
599379;113;61;52;39.5000;37.5000;41.8462
599361;131;67;64;48.2481;46.7239;49.8438
530689;927;492;435;39.8722;38.4533;41.4770
530701;324;169;155;45.0710;44.1686;46.0548
530719;92;47;45;45.5326;44.9894;46.1000
532509;58;32;26;47.5862;46.6875;48.6923
530751;355;171;184;39.5254;37.0673;41.8098
530760;529;287;242;37.4187;35.9355;39.1777
530778;210;113;97;42.5095;41.2611;43.9639
532592;230;110;120;42.0435;42.8182;41.3333
532541;138;65;73;40.6739;44.9000;36.9110
530816;1401;699;702;42.5828;40.0393;45.1154
532304;94;46;48;42.6064;42.7609;42.4583
530841;5739;2832;2907;43.8748;42.1497;45.5554
532061;597;294;303;40.6005;40.4456;40.7508
530867;334;174;160;40.8413;40.4540;41.2625
530883;11550;5592;5958;43.8173;42.3446;45.1996
532614;98;49;49;41.8163;44.9490;38.6837
530891;480;236;244;47.5750;43.9407;51.0902
530905;4569;2231;2338;43.2610;41.8774;44.5813
530913;395;212;183;41.0671;40.0189;42.2814
530921;418;213;205;43.6531;44.1244;43.1634
530948;1024;510;514;39.9209;39.5902;40.2490
532266;107;50;57;40.7710;41.0400;40.5351
513482;190;94;96;45.6053;45.3617;45.8438
571415;57;32;25;42.2193;41.0313;43.7400
531022;533;262;271;43.4962;42.9618;44.0129
531049;351;174;177;46.6823;42.5575;50.7373
534421;344;167;177;37.7442;37.5659;37.9124
531057;19641;9420;10221;41.7574;39.9145;43.4558
531073;320;157;163;43.8406;43.9140;43.7699
531081;974;475;499;41.0031;39.4221;42.5080
531090;345;155;190;39.7029;38.5129;40.6737
531103;546;268;278;36.1355;34.1679;38.0324
534145;229;115;114;41.9279;42.1870;41.6667
531120;448;225;223;43.0938;42.6067;43.5852
531138;1154;570;584;42.6889;42.2702;43.0976
531154;776;370;406;41.0052;39.6189;42.2685
531162;287;151;136;41.4408;39.0298;44.1176
531171;1083;521;562;39.4861;39.5653;39.4128
531189;6901;3365;3536;43.0234;41.3089;44.6550
531201;1832;944;888;42.3936;41.9799;42.8333
531219;391;200;191;42.5512;41.0800;44.0916
531227;1225;610;615;43.5049;41.9459;45.0512
531235;252;130;122;43.0317;41.6385;44.5164
531243;1951;965;986;39.5154;37.8959;41.1004
531251;506;257;249;44.3992;44.7568;44.0301
534455;238;117;121;42.2059;41.5598;42.8306
534447;699;368;331;40.8805;41.5462;40.1405
533670;983;500;483;38.5692;37.3900;39.7899
531294;1851;919;932;43.2407;42.3400;44.1288
531308;194;104;90;43.7062;42.8558;44.6889
531316;861;429;432;44.3211;42.7517;45.8796
531324;2430;1223;1207;44.0786;42.7110;45.4644
531332;253;133;120;39.3814;39.9812;38.7167
533793;124;55;69;40.4919;40.8455;40.2101
534072;298;161;137;43.4530;42.1708;44.9599
533203;9690;4806;4884;36.9570;36.2380;37.6644
531375;671;327;344;41.4925;41.2554;41.7180
533939;110;65;45;41.6273;43.1769;39.3889
533335;346;177;169;40.9624;40.6412;41.2988
531448;605;303;302;42.6140;41.3185;43.9139
531456;1197;601;596;40.0129;38.6980;41.3389
531464;1991;1025;966;40.5522;38.6688;42.5507
531472;1286;672;614;39.9230;38.2946;41.7052
534404;133;73;60;40.2368;40.1301;40.3667
533319;107;56;51;41.8084;41.8750;41.7353
534218;111;63;48;40.1937;40.1984;40.1875
531529;309;152;157;41.0663;40.0000;42.0987
531537;581;277;304;43.0869;44.1931;42.0789
531545;836;423;413;39.4234;38.5875;40.2797
533912;169;83;86;42.4941;42.0422;42.9302
533602;279;137;142;42.2455;41.1058;43.3451
534269;169;85;84;40.5000;39.3706;41.6429
531588;589;293;296;39.9992;38.3840;41.5980
531596;2082;1056;1026;41.6158;39.9972;43.2817
531600;695;336;359;42.8827;40.6131;45.0070
531626;428;225;203;42.7407;40.7889;44.9039
531634;805;408;397;43.4304;42.8309;44.0466
531642;328;172;156;43.5366;41.3953;45.8974
534111;176;84;92;41.0341;41.3214;40.7717
531669;517;261;256;42.4807;40.4962;44.5039
534285;232;113;119;41.2155;39.2876;43.0462
531685;669;335;334;43.7078;40.8851;46.5389
531693;908;463;445;41.7985;40.5432;43.1045
531715;487;251;236;42.5534;40.3207;44.9280
533963;127;56;71;43.5157;43.5714;43.4718
531740;540;279;261;39.7148;40.0018;39.4080
531758;558;275;283;41.0466;39.9109;42.1502
531766;450;230;220;41.0400;41.1826;40.8909
531782;483;264;219;43.2536;42.0303;44.7283
531791;523;271;252;42.2361;40.6328;43.9603
531804;180;93;87;40.3000;42.3817;38.0747
531812;815;404;411;38.1626;38.5594;37.7725
531839;879;439;440;42.5102;41.6595;43.3591
531847;1057;540;517;42.0951;41.4722;42.7456
531855;1240;604;636;39.8016;38.0695;41.4465
534463;230;110;120;45.2043;44.6455;45.7167
533106;504;269;235;37.2004;35.3141;39.3596
531880;185;93;92;40.4459;39.3172;41.5870
531901;669;328;341;42.1502;41.2774;42.9897
531910;406;208;198;42.7143;42.0481;43.4141
534234;100;51;49;44.8900;44.0294;45.7857
534048;271;132;139;42.0092;41.2348;42.7446
531944;1193;573;620;41.8445;41.2714;42.3742
531952;447;235;212;39.1935;37.9298;40.5943
531961;1006;492;514;37.3748;36.6118;38.1051
531979;914;458;456;41.3753;38.6507;44.1118
531995;1436;719;717;43.1003;41.3595;44.8459
532002;533;270;263;42.3837;41.9259;42.8536
532011;4201;2025;2176;43.1244;41.7089;44.4416
532029;2186;1089;1097;42.7475;41.5891;43.8974
599417;283;139;144;37.7332;36.7950;38.6389
535010;326;175;151;42.9601;41.1400;45.0695
532070;184;94;90;42.0217;42.0851;41.9556
532088;381;204;177;40.0984;39.7108;40.5452
535125;191;98;93;44.3010;42.2347;46.4785
532100;288;138;150;44.1944;41.8986;46.3067
532118;1997;983;1014;40.5391;39.9781;41.0828
532126;1096;529;567;41.9626;40.6588;43.1790
532142;923;467;456;42.4274;40.4336;44.4693
532169;3498;1697;1801;38.4531;37.1529;39.6782
532185;768;389;379;40.5352;39.1350;41.9723
532207;960;476;484;41.4583;39.7983;43.0909
532223;1698;816;882;40.5312;39.0748;41.8787
513130;314;163;151;42.1051;42.6288;41.5397
512991;171;80;91;45.5702;41.6625;49.0055
532274;1078;550;528;42.8599;41.7709;43.9943
532282;471;236;235;40.2070;39.5381;40.8787
532291;322;168;154;39.8323;38.4167;41.3766
513075;356;169;187;40.3652;42.6598;38.2914
532312;678;309;369;41.9469;42.8430;41.1965
532321;256;131;125;41.4492;41.2863;41.6200
535150;140;74;66;39.8071;36.5000;43.5152
532339;536;269;267;40.5989;39.6710;41.5337
532347;1359;685;674;38.9091;38.6285;39.1944
532355;487;245;242;43.1858;42.9286;43.4463
532363;497;256;241;41.6046;40.6758;42.5913
532371;2090;1044;1046;39.6617;38.9837;40.3384
532398;261;136;125;37.8257;39.3088;36.2120
532401;289;146;143;41.9187;40.9110;42.9476
532410;417;222;195;40.0492;40.3919;39.6590
532428;281;142;139;39.4715;37.6831;41.2986
532444;1225;607;618;43.5204;42.5297;44.4935
532452;1728;860;868;43.7870;42.8360;44.7293
513032;422;217;205;42.2204;41.3387;43.1537
532053;69337;33417;35920;42.5810;40.8842;44.1596
532461;1015;504;511;41.2734;41.2937;41.2534
532479;294;139;155;40.4218;41.0468;39.8613
532487;580;298;282;41.5724;40.8188;42.3688
532495;577;308;269;41.0823;39.8442;42.5000
535109;241;133;108;38.4710;37.0338;40.2407
571512;110;54;56;41.7364;41.7407;41.7321
532517;84;40;44;42.7381;41.7000;43.6818
532525;636;322;314;42.4811;41.1025;43.8949
541991;2242;1112;1130;40.6525;39.4128;41.8726
532533;493;237;256;43.3966;43.6097;43.1992
513041;656;313;343;42.1875;41.4617;42.8499
564150;66;35;31;34.5152;31.9000;37.4677
571601;384;195;189;38.5755;38.9513;38.1878
532576;3394;1711;1683;39.4375;39.1096;39.7709
532584;579;274;305;43.4465;43.0036;43.8443
571555;102;45;57;45.5490;47.1889;44.2544
535095;137;72;65;41.6752;41.2639;42.1308
532622;493;256;237;38.8185;36.7539;41.0485
532631;510;247;263;41.5451;40.1761;42.8308
513113;243;136;107;44.5947;41.4265;48.6215
532657;378;193;185;44.7169;44.2358;45.2189
571521;161;79;82;38.7484;38.1203;39.3537
532665;446;226;220;41.5762;40.3540;42.8318
532681;826;405;421;42.9964;41.0951;44.8254
564192;222;105;117;40.9685;40.2238;41.6368
532711;203;111;92;40.7759;39.5450;42.2609
532720;1930;964;966;41.9275;40.9658;42.8872
532738;590;295;295;41.9915;40.0492;43.9339
564125;197;93;104;41.4594;41.9301;41.0385
532754;331;174;157;40.7296;40.8333;40.6146
564087;221;106;115;44.1063;41.7453;46.2826
532762;471;258;213;41.6423;41.0233;42.3920
532771;389;194;195;42.8290;43.2113;42.4487
532797;364;195;169;41.7802;39.4692;44.4467
532801;326;171;155;40.4356;39.2719;41.7194
532819;15864;7768;8096;42.1879;40.6945;43.6208
532827;631;321;310;38.5967;37.8925;39.3258
532835;1964;942;1022;43.3478;40.7123;45.7769
532851;1029;517;512;36.7089;36.6083;36.8105
532860;5392;2622;2770;42.6523;40.8677;44.3415
599441;132;65;67;37.8864;40.3923;35.4552
551457;469;232;237;39.5128;39.6379;39.3903
599433;608;298;310;37.8750;37.2081;38.5161
532908;722;370;352;41.8338;40.7811;42.9403
532916;183;84;99;43.3907;45.6310;41.4899
532959;584;305;279;43.8699;43.1590;44.6470
532967;233;120;113;41.0322;41.1917;40.8628
532975;511;264;247;42.4511;39.9545;45.1194
532983;2648;1313;1335;41.4781;40.2548;42.6813
532177;615;306;309;41.2366;40.2451;42.2184
533009;376;194;182;38.4016;37.1031;39.7857
533017;4824;2346;2478;40.9270;39.3167;42.4516
533025;1794;909;885;41.1293;40.6177;41.6548
533033;1018;509;509;41.5324;41.9853;41.0796
533041;3080;1488;1592;43.5610;42.0356;44.9868
533050;2162;1123;1039;42.0282;41.3183;42.7955
533068;765;379;386;42.3915;40.7929;43.9611
571431;214;120;94;44.2477;40.7750;48.6809
571598;134;63;71;36.7537;35.9286;37.4859
533092;571;282;289;42.1725;42.1560;42.1886
571423;175;87;88;43.0314;41.4540;44.5909
533114;2263;1132;1131;41.1894;39.9390;42.4408
533122;876;432;444;41.2580;39.7315;42.7432
599425;197;101;96;38.9213;39.0545;38.7813
533149;839;423;416;41.5262;40.1738;42.9014
533157;694;359;335;39.9323;40.0292;39.8284
533173;247;122;125;42.3623;40.5246;44.1560
533181;1036;490;546;43.5135;40.1939;46.4927
533190;311;166;145;40.4228;37.1928;44.1207
533211;318;170;148;39.8836;38.1471;41.8784
533220;854;434;420;36.5867;36.5207;36.6548
533238;619;332;287;42.1688;40.3675;44.2526
533246;1749;867;882;40.4777;39.1805;41.7528
599476;154;82;72;47.9156;45.2439;50.9583
533262;1829;930;899;42.2091;41.9043;42.5245
533271;7049;3437;3612;41.9618;40.5730;43.2832
533289;765;376;389;42.2647;40.4654;44.0039
533297;481;250;231;39.1902;38.3400;40.1104
513181;120;59;61;47.4750;48.2627;46.7131
533301;847;413;434;35.8129;34.9165;36.6659
564681;254;121;133;43.3425;43.6322;43.0789
599450;85;45;40;48.7588;46.5667;51.2250
533327;516;247;269;40.6105;39.4514;41.6747
564800;532;257;275;34.5094;35.1498;33.9109
534994;197;96;101;41.8299;38.8021;44.7079
533343;490;246;244;44.8714;42.2642;47.5000
533351;720;361;359;40.1528;38.7770;41.5362
533360;529;256;273;36.6871;35.2266;38.0568
513415;215;105;110;42.8209;42.4810;43.1455
571687;127;67;60;43.3346;43.9179;42.6833
533386;1051;527;524;38.9396;37.8017;40.0840
533165;31973;15752;16221;42.7542;40.7509;44.6996
533394;970;478;492;40.4000;40.1276;40.6646
533408;633;324;309;42.2946;41.7315;42.8851
533424;1903;938;965;42.8946;40.5032;45.2192
533441;868;427;441;41.4067;41.3618;41.4501
533459;402;192;210;42.3955;41.2656;43.4286
599484;105;49;56;44.7667;45.3571;44.2500
533467;499;251;248;39.9248;39.2171;40.6411
571717;228;106;122;40.3860;40.9151;39.9262
533475;309;157;152;41.7718;41.9968;41.5395
533483;305;159;146;43.1262;42.3428;43.9795
513270;197;91;106;44.4543;41.4341;47.0472
533505;309;152;157;42.2638;41.6250;42.8822
533513;347;165;182;38.9035;37.0152;40.6154
564702;101;58;43;40.6683;40.5172;40.8721
513288;171;93;78;40.4883;40.0806;40.9744
533521;715;365;350;40.0385;38.1521;42.0057
571636;379;189;190;39.7797;39.5212;40.0368
533530;1305;663;642;41.3621;39.6282;43.1526
533556;297;157;140;42.3822;40.7229;44.2429
533572;889;501;388;41.7396;40.4242;43.4381
513423;349;178;171;45.1074;43.3933;46.8918
537641;4814;2360;2454;42.5540;40.9661;44.0811
533581;1926;966;960;39.3017;37.7712;40.8417
537675;597;289;308;43.1549;43.0779;43.2273
533599;645;323;322;44.5636;43.7663;45.3634
513237;176;92;84;43.5057;41.4674;45.7381
513148;190;100;90;41.0842;40.7900;41.4111
537705;1565;776;789;41.4284;40.6881;42.1565
513369;297;150;147;40.9646;40.5467;41.3912
513393;450;214;236;41.3089;40.1449;42.3644
533611;824;424;400;36.9187;36.6297;37.2250
533629;1233;608;625;40.2056;38.5872;41.7800
533637;375;176;199;41.7827;42.3807;41.2538
533645;492;244;248;44.3516;42.9426;45.7379
533653;591;300;291;43.9450;42.2700;45.6718
537748;621;329;292;39.3792;37.9073;41.0377
533661;541;273;268;38.6072;38.1410;39.0821
533696;212;103;109;41.0000;39.8786;42.0596
533700;1639;817;822;42.5238;41.6652;43.3771
533726;557;284;273;47.2594;47.9789;46.5110
537888;646;300;346;40.7012;39.7400;41.5347
533734;534;270;264;39.4513;38.5667;40.3561
533742;347;159;188;41.9870;39.9025;43.7500
533751;541;260;281;39.4242;38.4846;40.2936
533769;967;481;486;43.1939;41.4148;44.9547
533777;557;283;274;37.3330;36.4682;38.2263
533785;1034;508;526;38.1122;36.6929;39.4829
533807;2077;1015;1062;42.6069;41.7345;43.4407
533815;357;184;173;45.4580;43.7011;47.3266
533823;261;129;132;41.1475;41.2519;41.0455
533831;2224;1129;1095;42.3323;40.3547;44.3712
533840;2419;1187;1232;42.0250;40.5792;43.4180
533858;1419;693;726;42.2569;41.0397;43.4187
533866;1088;543;545;42.1783;41.2422;43.1110
533882;522;266;256;41.9464;42.1316;41.7539
564826;278;144;134;44.7806;43.7014;45.9403
533891;396;202;194;37.6338;37.3911;37.8866
513202;108;61;47;50.6852;49.2377;52.5638
533921;1994;1002;992;41.6184;40.8253;42.4194
513261;239;116;123;45.1276;42.7328;47.3862
513164;362;177;185;43.8757;42.2345;45.4459
538035;454;212;242;45.5947;44.6321;46.4380
533947;1705;879;826;41.9035;40.3942;43.5097
531367;125;64;61;46.7640;47.1563;46.3525
531111;190;93;97;45.3421;44.1344;46.5000
533971;613;311;302;44.4184;42.2170;46.6854
530964;25;15;10;54.9400;51.3000;60.4000
533980;422;205;217;43.9716;43.3049;44.6014
530832;115;58;57;48.2913;48.2759;48.3070
531286;380;178;202;44.8553;43.8708;45.7228
533998;1319;637;682;39.8745;38.7386;40.9355
534005;10322;4923;5399;42.5988;40.7003;44.3300
529524;29;16;13;49.7759;49.5000;50.1154
534013;386;203;183;45.0104;44.7069;45.3470
534021;658;332;326;45.2979;44.3404;46.2730
534030;426;215;211;44.9484;43.9465;45.9692
529559;108;56;52;44.8241;45.5893;44.0000
531260;93;51;42;48.5000;48.6765;48.2857
531341;411;204;207;45.4416;44.2157;46.6498
531197;614;311;303;38.6743;36.5289;40.8762
531430;389;192;197;44.2404;43.2604;45.1954
534056;392;198;194;46.3087;47.2980;45.2990
531359;395;191;204;41.7810;40.3953;43.0784
531481;176;85;91;49.1023;47.7471;50.3681
534064;239;131;108;42.3452;42.2328;42.4815
531413;101;51;50;50.6683;44.6569;56.8000
534081;260;132;128;44.6962;44.4848;44.9141
534099;738;374;364;44.1545;43.8663;44.4505
534102;747;396;351;41.7222;39.5631;44.1581
534129;803;389;414;43.4589;42.7853;44.0918
534137;513;271;242;42.7261;41.9871;43.5537
531405;202;96;106;42.2723;41.3854;43.0755
551465;54;24;30;42.1111;41.7500;42.4000
534153;403;187;216;44.3412;45.0829;43.6991
534161;688;348;340;40.5102;38.9885;42.0676
533955;20653;10113;10540;43.2189;41.7314;44.6462
534170;181;92;89;44.0138;43.1630;44.8933
534188;1029;504;525;42.4427;42.0476;42.8219
534200;1106;559;547;40.4259;40.0367;40.8236
530999;405;200;205;40.4160;39.6600;41.1537
534226;212;104;108;41.3396;40.6442;42.0093
534242;880;467;413;41.8795;40.1338;43.8535
534251;184;92;92;42.1413;40.9674;43.3152
534277;321;168;153;41.4159;40.2619;42.6830
530956;139;78;61;44.3561;43.4103;45.5656
531278;201;98;103;42.0174;41.4286;42.5777
534307;158;92;66;48.4177;46.7065;50.8030
534315;291;140;151;45.0086;44.0857;45.8642
534323;132;64;68;45.8333;41.4844;49.9265
528196;229;116;113;45.4345;46.5948;44.2434
534331;648;305;343;41.4151;42.7754;40.2055
534340;383;191;192;42.1554;41.4267;42.8802
534358;513;269;244;46.5117;45.9796;47.0984
526622;310;165;145;43.6613;41.4273;46.2034
534366;244;123;121;44.9262;43.8577;46.0124
534374;172;87;85;48.6221;48.4310;48.8176
530859;272;132;140;43.1912;44.3409;42.1071
531383;79;42;37;46.7532;45.5952;48.0676
534391;146;77;69;44.0342;43.8247;44.2681
534293;164;87;77;49.5244;47.2126;52.1364
531065;140;68;72;41.1429;41.1471;41.1389
534412;287;151;136;43.4129;40.8642;46.2426
530875;132;76;56;48.1591;44.8421;52.6607
531391;86;41;45;42.0465;40.0854;43.8333
534439;1111;582;529;43.8393;42.5893;45.2146
534196;875;431;444;42.8074;42.6206;42.9887
531421;86;34;52;46.8605;49.4706;45.1538
530930;150;73;77;42.7467;41.5959;43.8377
530981;279;141;138;38.7151;38.4645;38.9710
530972;111;61;50;48.0495;43.6148;53.4600
571741;129;70;59;45.7558;44.7857;46.9068
534480;669;347;322;40.1831;37.9669;42.5714
534498;3118;1551;1567;43.5427;41.4671;45.5970
534501;514;261;253;43.7198;43.6648;43.7767
534510;665;333;332;42.8233;42.4459;43.2018
534528;548;270;278;40.2391;38.9370;41.5036
534536;242;118;124;44.9132;41.7627;47.9113
534544;263;129;134;43.1692;42.8488;43.4776
534552;243;125;118;39.5494;38.9160;40.2203
534561;459;220;239;46.6264;45.9636;47.2364
534579;612;319;293;43.9330;43.1176;44.8208
531014;87;42;45;48.9138;48.9048;48.9222
534587;2946;1495;1451;42.7468;41.3997;44.1347
534595;845;417;428;41.6775;40.0995;43.2150
534609;468;250;218;42.2115;40.5240;44.1468
534617;1401;719;682;44.7898;43.3456;46.3123
534625;626;316;310;45.8435;45.3070;46.3903
534633;4861;2385;2476;45.3562;43.4270;47.2145
534641;349;176;173;41.6289;40.9886;42.2803
534650;799;413;386;38.9643;37.0109;41.0544
534668;1339;665;674;43.1751;42.0429;44.2923
534714;479;265;214;38.4854;37.1189;40.1776
534722;1395;694;701;39.9452;38.2550;41.6184
534731;1251;651;600;40.2754;39.4232;41.2000
598291;737;379;358;35.9912;35.2493;36.7765
534749;673;343;330;40.5134;39.0802;42.0030
531570;177;99;78;45.6469;41.2778;51.1923
539201;924;449;475;39.2760;38.9031;39.6284
534765;1495;764;731;40.4217;39.7134;41.1621
531987;96;45;51;41.0729;38.2778;43.5392
534773;494;241;253;38.6781;38.2012;39.1324
534790;1269;663;606;42.9783;41.8967;44.1617
534803;841;427;414;41.9756;41.4180;42.5507
531499;319;174;145;40.4122;39.1552;41.9207
531928;332;171;161;43.7349;40.6754;46.9845
534820;494;252;242;40.3826;39.8333;40.9545
534838;550;293;257;41.0636;38.2952;44.2198
534846;538;274;264;42.1766;40.3832;44.0379
531871;226;117;109;44.1327;42.1325;46.2798
531774;146;66;80;40.1986;37.8030;42.1750
531651;90;49;41;43.7778;41.1327;46.9390
534897;1549;766;783;37.4593;36.8708;38.0351
538345;807;409;398;40.5855;38.7029;42.5201
534901;368;178;190;42.6250;41.4157;43.7579
534935;4224;2121;2103;39.9392;39.0097;40.8766
571792;448;230;218;39.7455;38.7739;40.7706
534951;18388;9137;9251;42.6459;40.9779;44.2932
534978;649;336;313;41.6140;41.1518;42.1102
531898;294;143;151;44.9286;43.8497;45.9503
535001;1067;541;526;41.0876;39.9399;42.2681
571784;2248;1139;1109;42.0916;41.4078;42.7940
531502;495;238;257;41.5505;40.7017;42.3366
531677;149;74;75;38.2785;39.2297;37.3400
535028;1451;726;725;43.4593;41.6006;45.3207
535036;1110;535;575;39.0883;39.1766;39.0061
529575;146;76;70;40.5205;40.5263;40.5143
535044;993;495;498;40.6772;39.2313;42.1145
534676;19559;9441;10118;43.0122;41.2391;44.6666
535052;1458;688;770;42.9595;40.9985;44.7117
535061;432;211;221;42.2593;41.6232;42.8665
531863;311;147;164;40.4325;38.2687;42.3720
535079;2114;1072;1042;37.6291;36.9291;38.3493
535087;16191;7871;8320;42.5987;41.1920;43.9294
531707;183;89;94;46.3142;44.0281;48.4787
535117;1105;577;528;42.7643;41.3458;44.3144
535133;1549;766;783;37.4490;36.5757;38.3033
532673;545;272;273;42.3881;40.9191;43.8516
535141;510;267;243;41.5235;40.7921;42.3272
538647;1462;706;756;33.0287;32.8215;33.2222
535168;692;345;347;40.3324;40.2594;40.4049
535192;526;278;248;38.7662;38.1942;39.4073
531731;198;106;92;45.3535;41.8491;49.3913
535214;435;222;213;43.9046;42.6757;45.1854
535222;2389;1170;1219;39.5774;38.2154;40.8847
531561;777;391;386;38.0290;38.3926;37.6606
529583;138;78;60;44.0435;42.0897;46.5833
599492;142;68;74;42.4014;40.7794;43.8919
535257;915;475;440;40.5590;40.1126;41.0409
535265;1129;573;556;40.2334;39.6937;40.7896
535273;2208;1068;1140;39.3822;39.0515;39.6921
531936;122;67;55;46.9098;46.1418;47.8455
535290;822;413;409;40.0718;38.8898;41.2653
535303;900;457;443;40.1789;39.2659;41.1208
535311;367;183;184;44.1322;42.2158;46.0380
535320;2319;1171;1148;41.2792;39.5256;43.0679
535338;911;464;447;40.5582;40.1703;40.9609
535354;408;228;180;42.2574;40.9912;43.8611
531511;576;295;281;35.9253;35.2051;36.6815
535389;486;253;233;40.9198;40.2945;41.5987
535397;511;260;251;41.4726;40.9038;42.0618
535427;5175;2603;2572;42.4186;41.1481;43.7045
535443;4792;2444;2348;42.7663;41.4133;44.1746
535451;7459;3711;3748;41.8301;39.9802;43.6617
535478;961;491;470;39.7726;39.3452;40.2191
565750;114;53;61;40.4474;40.6698;40.2541
535486;381;211;170;41.9619;40.1825;44.1706
535508;265;120;145;38.7340;40.8583;36.9759
535516;494;254;240;39.9453;38.7874;41.1708
570788;1356;700;656;37.6895;37.3443;38.0579
571946;240;122;118;44.3792;43.8443;44.9322
535559;1052;524;528;41.3289;39.9905;42.6572
535567;408;210;198;41.2475;39.3095;43.3030
535583;1047;533;514;37.6051;36.9428;38.2918
599514;347;179;168;38.9755;38.2654;39.7321
535605;733;358;375;38.4727;37.7877;39.1267
570991;146;72;74;38.8288;39.1528;38.5135
535621;885;450;435;41.6605;40.9911;42.3529
535630;824;411;413;40.2051;39.9331;40.4758
570818;262;138;124;40.3740;40.2246;40.5403
535656;446;235;211;39.5112;38.6489;40.4716
535672;3421;1723;1698;42.3746;41.0270;43.7420
571989;281;149;132;42.4715;41.3993;43.6818
535702;2788;1390;1398;41.3633;40.1554;42.5644
535711;251;131;120;38.5757;36.5534;40.7833
535729;343;162;181;41.1589;41.2901;41.0414
570940;310;156;154;36.9161;36.4423;37.3961
535745;266;140;126;45.8985;43.6000;48.4524
571067;157;84;73;37.7102;37.9881;37.3904
535818;588;297;291;38.4116;37.7357;39.1014
535834;242;121;121;42.3802;41.8058;42.9545
599531;313;153;160;37.4201;38.8595;36.0438
535869;705;361;344;40.4121;40.6302;40.1831
565733;225;106;119;39.5356;37.8396;41.0462
599522;159;75;84;42.0660;44.2867;40.0833
565784;314;161;153;39.1529;38.5373;39.8007
535923;425;230;195;40.5447;39.0435;42.3154
535931;1272;662;610;35.8074;35.0846;36.5918
571849;203;97;106;40.8448;38.8505;42.6698
535966;442;224;218;42.4389;41.4821;43.4220
535974;485;252;233;39.6691;39.7659;39.5644
566039;334;155;179;41.7545;40.8613;42.5279
529613;438;231;207;39.6484;38.1797;41.2874
536008;835;424;411;40.3563;40.5165;40.1910
536024;999;525;474;37.1136;36.3610;37.9473
571075;71;33;38;44.9225;44.0455;45.6842
536041;2147;1056;1091;39.8847;38.5928;41.1352
571172;154;80;74;36.1104;36.1750;36.0405
536067;450;253;197;41.4844;39.5079;44.0228
570974;404;208;196;36.2946;35.5673;37.0663
599557;88;47;41;41.8750;42.9681;40.6220
570826;5233;2851;2382;41.8371;41.1598;42.6478
536121;516;252;264;39.0504;38.4167;39.6553
566047;225;106;119;39.1844;40.4340;38.0714
571971;143;74;69;41.6678;39.1892;44.3261
572012;117;69;48;45.8162;43.2246;49.5417
536164;202;97;105;40.3960;40.9433;39.8905
536172;572;294;278;39.7080;39.1905;40.2554
536181;932;463;469;41.1717;39.3164;43.0032
536202;392;202;190;44.5383;44.5248;44.5526
536211;157;77;80;39.3981;38.8896;39.8875
565563;364;191;173;39.0440;38.2592;39.9104
570770;173;82;91;45.2110;41.6341;48.4341
536261;346;173;173;40.4104;39.0260;41.7948
536270;2212;1064;1148;39.0940;37.8976;40.2030
565644;531;265;266;41.8333;42.3453;41.3233
535419;44740;22717;22023;42.4904;41.0038;44.0239
536326;8846;4375;4471;43.1076;41.3859;44.7923
565822;93;47;46;43.5108;41.1809;45.8913
571865;204;92;112;43.2794;42.5326;43.8929
536334;188;95;93;42.0851;42.0789;42.0914
571156;152;78;74;41.2039;41.5513;40.8378
536351;422;201;221;40.0142;41.2363;38.9027
571997;67;35;32;39.8134;36.1857;43.7813
571121;298;156;142;44.8121;44.9808;44.6268
536377;274;137;137;40.5730;40.0109;41.1350
571806;291;146;145;41.4072;41.0959;41.7207
570893;207;100;107;42.1135;42.7200;41.5467
536407;249;132;117;43.4036;42.3561;44.5855
571032;198;107;91;42.4495;40.5935;44.6319
598241;76;40;36;37.6842;34.7000;41.0000
536431;304;156;148;39.8553;39.6667;40.0541
536440;946;474;472;38.0518;37.3354;38.7712
536458;500;266;234;41.0340;40.5827;41.5470
565580;237;126;111;39.3397;37.2698;41.6892
570753;93;48;45;41.1774;39.0625;43.4333
536491;862;447;415;40.7100;38.7036;42.8711
570923;122;68;54;47.2869;46.8235;47.8704
571938;298;148;150;39.8792;40.7500;39.0200
565652;58;34;24;50.5345;48.8235;52.9583
565636;267;142;125;38.1330;36.8944;39.5400
529605;298;156;142;38.6275;38.4872;38.7817
571148;152;85;67;42.2368;39.3000;45.9627
536580;723;356;367;42.0228;41.5365;42.4946
565661;88;44;44;42.0682;40.1136;44.0227
529591;241;122;119;38.1971;37.1148;39.3067
536610;764;388;376;39.4777;37.8995;41.1064
599573;127;62;65;41.5787;40.3065;42.7923
536636;400;191;209;40.9175;41.6518;40.2464
557030;642;313;329;40.8411;39.6949;41.9316
536652;712;360;352;43.9579;43.9778;43.9375
536661;561;279;282;40.8957;41.5789;40.2199
565539;299;157;142;41.1622;39.8567;42.6056
536709;282;147;135;42.8191;41.6020;44.1444
571881;128;61;67;43.4609;43.8934;43.0672
536717;186;94;92;39.6290;38.9894;40.2826
565920;99;50;49;42.7020;40.4600;44.9898
536768;365;182;183;42.6534;41.4890;43.8115
570982;364;176;188;39.5632;39.2159;39.8883
570761;105;51;54;44.9857;45.5980;44.4074
536857;396;195;201;40.8308;40.0590;41.5796
565725;134;72;62;43.6493;41.6806;45.9355
565628;328;159;169;40.5335;40.1101;40.9320
570842;295;150;145;44.0661;44.1200;44.0103
565571;423;215;208;43.8144;45.0628;42.5240
572021;165;91;74;38.5970;41.8626;34.5811
536938;680;348;332;41.7176;41.5833;41.8584
571814;602;311;291;38.4585;36.7315;40.3041
536971;1428;716;712;41.5602;40.8003;42.3244
536989;411;222;189;41.4367;40.0495;43.0661
536997;363;186;177;38.4559;36.1505;40.8785
537021;835;405;430;43.7311;43.2630;44.1721
537039;872;418;454;41.1938;40.4593;41.8700
537047;388;214;174;42.9098;41.7617;44.3218
537055;653;337;316;40.7006;39.3605;42.1297
599301;151;69;82;38.5596;37.8188;39.1829
599671;233;122;111;43.6717;42.0328;45.4730
537080;503;248;255;44.6213;41.7500;47.4137
537098;220;104;116;47.6636;43.7404;51.1810
537101;242;116;126;40.7603;39.0948;42.2937
537110;560;272;288;41.7161;40.7610;42.6181
537128;890;442;448;40.5247;39.3281;41.7054
534854;165;78;87;39.1061;38.9615;39.2356
537152;815;402;413;42.0644;42.0771;42.0521
537161;268;136;132;43.6418;42.4632;44.8561
537179;647;332;315;42.0703;39.9608;44.2937
599638;559;283;276;42.4803;41.5318;43.4529
599620;431;226;205;41.3051;41.1858;41.4366
537217;448;226;222;43.8884;43.1460;44.6441
537225;325;169;156;47.5615;45.0385;50.2949
537233;538;274;264;41.8104;39.4234;44.2879
534706;216;106;110;47.7824;47.5472;48.0091
537250;343;174;169;42.6487;41.5747;43.7544
599581;269;141;128;41.5520;40.5142;42.6953
537268;383;195;188;41.8916;41.1103;42.7021
537276;544;283;261;41.7574;39.5989;44.0977
537292;505;239;266;44.8762;45.1234;44.6541
551481;169;88;81;43.4172;41.5227;45.4753
537306;92;38;54;46.3696;43.9737;48.0556
537314;857;435;422;43.7975;42.2264;45.4171
529630;314;171;143;43.0637;42.5994;43.6189
537331;1844;915;929;41.8248;40.3689;43.2589
537349;364;182;182;43.1978;42.6758;43.7198
537357;1474;710;764;39.2144;38.5887;39.7958
534943;325;162;163;40.6600;40.8086;40.5123
537373;867;418;449;42.0190;41.0048;42.9633
537390;734;364;370;44.2888;43.0467;45.5108
537403;409;206;203;41.4120;39.9369;42.9089
537411;1269;653;616;44.0516;42.3132;45.8945
537438;1274;619;655;44.3203;43.4370;45.1550
537446;1368;660;708;42.9576;42.4197;43.4590
537454;9795;4747;5048;40.6745;39.3418;41.9277
537462;390;192;198;44.7590;45.4792;44.0606
537489;2846;1383;1463;43.9498;42.5268;45.2949
537497;313;164;149;40.6406;38.5915;42.8960
537501;12098;5985;6113;34.1212;33.1060;35.1151
534919;234;121;113;42.1197;39.8306;44.5708
599654;73;42;31;43.2808;39.5238;48.3710
537004;15154;7235;7919;42.3503;40.7176;43.8421
537551;320;169;151;43.4438;42.0917;44.9570
537560;198;103;95;44.6364;42.6456;46.7947
537578;454;227;227;45.9273;45.5837;46.2709
537586;889;442;447;43.4966;42.9615;44.0257
599662;166;91;75;44.8916;44.6429;45.1933
537616;572;287;285;43.1399;41.9530;44.3351
537624;573;290;283;40.8508;41.1345;40.5601
537632;736;396;340;40.8478;38.7576;43.2824
537659;471;228;243;43.2792;41.6447;44.8128
537667;414;215;199;44.9155;43.4163;46.5352
537683;14377;6870;7507;43.1010;41.2197;44.8226
599590;195;99;96;43.3974;39.2576;47.6667
537721;1217;619;598;40.8788;40.2480;41.5318
537756;1649;830;819;43.8493;42.0422;45.6807
537764;3204;1582;1622;43.0955;42.0992;44.0672
537772;538;260;278;42.6171;43.4769;41.8129
534757;216;107;109;45.7500;44.4813;46.9954
537781;1353;697;656;40.5894;39.7281;41.5046
537799;191;98;93;42.1283;39.0510;45.3710
537802;497;246;251;46.5946;47.8821;45.3327
537811;1046;541;505;42.5163;40.5721;44.5990
537837;798;366;432;39.5226;39.6120;39.4468
534889;179;91;88;43.7514;45.8077;41.6250
537853;533;272;261;42.3368;41.7206;42.9789
537861;625;311;314;38.8776;39.3907;38.3694
537896;925;436;489;41.5659;41.8440;41.3180
537900;318;168;150;42.5566;41.2143;44.0600
536083;209;103;106;43.7967;41.8204;45.7170
534871;326;162;164;39.5798;38.3951;40.7500
537942;324;159;165;42.1049;44.1352;40.1485
537951;84;42;42;48.9167;46.9524;50.8810
599611;172;91;81;49.2035;47.3571;51.2778
537977;529;277;252;39.0028;38.4747;39.5833
537985;791;387;404;40.3723;40.8333;39.9307
537993;401;201;200;39.4027;39.6692;39.1350
534471;425;230;195;41.5682;39.4391;44.0795
599697;237;113;124;41.8207;41.5619;42.0565
534862;285;136;149;40.9702;40.3382;41.5470
503410;183;95;88;45.5219;44.9211;46.1705
538043;1265;616;649;35.6621;35.9968;35.3444
538051;2816;1461;1355;33.9023;33.4843;34.3531
534684;321;160;161;42.4533;42.3625;42.5435
538086;887;410;477;40.3963;38.5073;42.0199
538094;19255;9424;9831;40.5790;39.3444;41.7624
538108;678;332;346;41.6121;40.4639;42.7139
564869;591;302;289;37.4645;37.6887;37.2301
538132;12273;5997;6276;41.1352;39.7361;42.4721
533254;348;179;169;43.7989;42.5112;45.1627
538141;692;354;338;40.7124;39.5169;41.9645
565008;330;164;166;36.5515;37.0854;36.0241
538167;1227;616;611;39.2620;38.7662;39.7619
564885;492;249;243;37.1646;35.7209;38.6440
538191;811;399;412;38.9353;36.8609;40.9442
534781;1067;572;495;40.2582;39.2080;41.4717
564915;861;431;430;33.0517;32.2703;33.8349
565989;527;288;239;37.6252;37.6146;37.6381
538221;1538;775;763;35.5117;34.9348;36.0976
538230;2514;1276;1238;38.8115;37.4639;40.2003
538248;852;421;431;38.9143;38.6686;39.1543
538256;1510;732;778;38.7503;38.1011;39.3612
538264;1356;644;712;34.7323;34.0140;35.3820
533378;784;398;386;40.7755;40.1432;41.4275
538272;2901;1438;1463;38.0719;36.7448;39.3763
538281;327;177;150;39.2462;38.2401;40.4333
538299;4664;2275;2389;39.8844;38.7053;41.0073
564974;785;379;406;43.5561;43.7375;43.3867
538311;3608;1808;1800;38.0399;36.9209;39.1639
538329;449;238;211;39.2506;36.7983;42.0166
513628;273;133;140;39.3828;37.2218;41.4357
531553;315;167;148;41.2905;39.5240;43.2838
564761;280;145;135;36.7964;36.8655;36.7222
533416;3780;1878;1902;42.0265;40.7039;43.3323
538370;720;349;371;39.8597;37.8295;41.7695
536130;509;241;268;39.1758;39.6743;38.7276
533432;934;473;461;38.7537;37.5698;39.9685
534960;276;134;142;42.8623;44.5821;41.2394
564991;897;428;469;35.4788;35.3949;35.5554
538418;253;113;140;38.9783;38.3053;39.5214
538426;1652;801;851;38.2113;37.0293;39.3237
564982;1719;839;880;34.4110;33.7729;35.0193
538914;1398;702;696;40.5486;39.6296;41.4756
534986;483;249;234;43.3571;41.8213;44.9915
538442;2953;1466;1487;35.8214;35.0157;36.6157
538451;1137;556;581;39.9055;39.4982;40.2952
538469;371;181;190;43.0148;41.6547;44.3105
538477;1957;961;996;37.7938;36.7862;38.7661
538485;1441;721;720;39.7956;38.4085;41.1847
538493;3902;1933;1969;38.6738;37.9221;39.4116
598267;582;334;248;39.6031;38.6587;40.8750
538507;1403;714;689;39.5135;38.6527;40.4057
538515;1382;709;673;37.5810;36.3773;38.8492
538523;2619;1307;1312;39.1105;37.6951;40.5206
538540;3575;1766;1809;32.9484;32.7933;33.0998
538558;1351;635;716;33.0640;32.2780;33.7612
538566;466;231;235;42.9742;42.5260;43.4149
533548;383;195;188;41.3930;38.8897;43.9894
564907;1871;919;952;32.4583;31.6034;33.2836
538574;6136;2985;3151;39.2572;38.1104;40.3435
533564;982;506;476;41.3870;39.5553;43.3340
538582;1799;905;894;38.3671;38.2215;38.5145
571679;107;49;58;42.4065;44.7653;40.4138
538604;613;315;298;40.4755;38.6873;42.3658
529656;240;123;117;35.5500;35.1504;35.9701
538612;577;285;292;38.8345;39.3175;38.3630
538621;558;273;285;43.0645;42.6245;43.4860
538639;339;168;171;35.2316;35.2560;35.2076
599221;415;201;214;35.6759;35.2214;36.1028
564788;77;39;38;44.0065;40.0385;48.0789
538655;1146;545;601;35.1178;35.0101;35.2155
538671;1849;939;910;36.5995;35.1486;38.0967
538698;480;238;242;39.3854;40.1891;38.5950
538701;1021;515;506;38.3570;37.9913;38.7292
538728;15908;7698;8210;39.9155;38.6394;41.1119
598283;417;221;196;37.9892;37.4276;38.6224
538752;1245;605;640;41.5675;40.9727;42.1297
538761;912;455;457;37.9901;37.5505;38.4278
538779;700;343;357;41.9714;41.0918;42.8165
538787;586;283;303;38.8396;39.4011;38.3152
538809;2524;1256;1268;38.2072;37.6099;38.7989
538825;884;439;445;39.2851;39.4749;39.0978
533718;1400;708;692;41.7686;40.9435;42.6127
571954;496;245;251;40.6230;39.7449;41.4801
538833;2106;1009;1097;37.0366;37.5377;36.5757
598305;512;269;243;33.0977;32.9126;33.3025
538841;1253;618;635;38.4689;36.9984;39.9000
538850;1120;547;573;38.1205;36.2166;39.9380
538876;3905;1881;2024;36.3156;35.1401;37.4081
538884;1909;942;967;37.0689;35.8854;38.2218
571644;203;105;98;41.1502;41.9000;40.3469
538892;1028;503;525;35.8609;35.4742;36.2314
599719;631;294;337;37.8946;37.5884;38.1617
538957;6884;3398;3486;39.4564;38.2549;40.6277
538965;1641;813;828;35.4433;35.7054;35.1860
538973;382;183;199;36.8639;37.5437;36.2387
538981;2940;1453;1487;39.4105;38.6679;40.1362
538990;625;298;327;38.6616;37.9262;39.3318
533874;196;107;89;46.0867;46.4252;45.6798
539015;691;349;342;38.6534;38.2106;39.1053
539031;921;458;463;37.9864;38.1856;37.7894
539040;654;317;337;40.9235;41.1278;40.7315
564796;172;84;88;39.1337;37.5595;40.6364
533904;715;342;373;42.8874;41.8713;43.8190
505781;876;462;414;40.6164;40.0801;41.2150
535362;1029;515;514;38.9208;38.3699;39.4728
539058;3805;1946;1859;36.6235;36.1423;37.1272
539066;3185;1599;1586;36.6096;36.2398;36.9823
513644;369;171;198;34.6843;36.2427;33.3384
539082;844;425;419;31.4763;31.2506;31.7053
539091;560;277;283;41.4196;38.8755;43.9099
539104;488;274;214;42.9057;42.0182;44.0421
571199;196;85;111;40.3673;42.9471;38.3919
599735;1252;620;632;40.1478;39.5968;40.6883
540048;352;187;165;42.0994;40.7888;43.5848
539121;487;253;234;38.6027;38.5870;38.6197
539139;7331;3593;3738;40.1752;38.9748;41.3291
532215;1434;702;732;38.0788;37.1994;38.9221
539147;303;162;141;42.6650;40.4012;45.2660
539155;1104;542;562;41.9891;41.8376;42.1352
539163;1765;889;876;40.2632;38.5855;41.9658
539171;563;293;270;41.0311;39.8311;42.3333
539180;372;183;189;39.8199;40.9645;38.7116
539198;3722;1843;1879;40.1553;38.5667;41.7134
539210;4231;2093;2138;36.8597;36.3032;37.4046
531146;1142;569;573;34.8835;33.6564;36.1021
539228;2076;987;1089;34.4446;33.6388;35.1749
539236;4463;2166;2297;37.8058;36.7290;38.8213
539244;8788;4184;4604;39.2511;38.0801;40.3154
539252;2222;1090;1132;41.2565;40.2147;42.2597
539261;517;261;256;42.5019;42.8755;42.1211
539287;374;182;192;38.6604;39.1429;38.2031
539295;1001;485;516;38.2213;37.6649;38.7442
539309;3730;1846;1884;31.4697;30.7779;32.1476
513431;410;198;212;41.6415;40.5253;42.6840
539317;1288;642;646;41.8043;40.0794;43.5186
539325;9682;4684;4998;35.7942;34.9953;36.5428
539333;4857;2381;2476;39.7287;38.8482;40.5755
539341;640;330;310;44.8656;44.5000;45.2548
539350;1991;929;1062;35.4769;34.5269;36.3079
539368;1442;734;708;43.3128;41.6907;44.9944
599727;548;295;253;41.4434;40.9746;41.9901
571211;742;364;378;39.7642;38.2445;41.2275
539384;618;303;315;42.8479;42.3614;43.3159
539392;897;438;459;41.2113;39.2374;43.0948
571261;543;255;288;42.3711;41.5471;43.1007
539406;1563;752;811;39.1449;38.7527;39.5086
539414;3458;1709;1749;40.6978;39.6094;41.7613
539422;1469;729;740;39.2270;37.9102;40.5243
571326;402;198;204;37.3731;35.8384;38.8627
539457;765;390;375;40.1928;40.2564;40.1267
539490;851;409;442;43.9219;43.4804;44.3303
540765;5933;2840;3093;39.5823;37.9968;41.0380
531618;2248;1114;1134;36.9795;36.4919;37.4586
539503;1395;718;677;40.1688;39.3872;40.9978
571334;104;54;50;42.3462;40.1667;44.7000
539511;708;373;335;41.6921;40.3954;43.1358
539520;981;485;496;42.6030;39.5247;45.6129
539546;737;390;347;42.7659;42.2333;43.3646
539562;367;182;185;41.2575;42.7802;39.7595
539571;2934;1439;1495;41.0552;40.2561;41.8244
539597;4064;1983;2081;39.0315;38.6891;39.3578
532789;907;440;467;38.0083;38.0409;37.9775
571318;229;113;116;41.9454;40.4204;43.4310
539627;8645;4213;4432;39.7603;38.7217;40.7475
531723;5153;2528;2625;39.3201;37.8398;40.7457
539643;3570;1723;1847;41.4922;40.4890;42.4280
539651;1288;608;680;38.2158;37.3503;38.9897
539660;860;423;437;45.2023;43.5804;46.7723
539686;1536;772;764;39.7044;38.7953;40.6230
539708;1207;610;597;40.6069;40.1164;41.1080
571342;300;149;151;41.7567;40.2919;43.2020
539732;2042;1010;1032;41.7194;40.5752;42.8391
531821;886;434;452;39.6907;37.8710;41.4381
598313;474;237;237;37.8671;37.0865;38.6477
539759;1470;716;754;39.9660;39.4763;40.4310
539767;1538;751;787;39.7432;39.4960;39.9790
539775;825;393;432;40.0055;39.3346;40.6157
571351;798;404;394;40.3972;38.9851;41.8452
532991;1155;535;620;40.9840;40.1523;41.7016
539805;804;393;411;38.1629;37.4746;38.8212
539813;3533;1651;1882;35.6489;35.4491;35.8241
513458;2739;1312;1427;35.9838;35.8544;36.1027
539830;556;272;284;39.4568;38.7610;40.1232
539848;2632;1280;1352;40.8332;40.5539;41.0976
539856;1689;831;858;42.4663;41.7082;43.2005
571288;304;154;150;41.4178;42.4091;40.4000
539872;1367;687;680;38.0355;38.8683;37.1941
539881;1348;663;685;40.9941;40.3175;41.6489
539902;1933;977;956;38.9558;38.5420;39.3787
529672;142;77;65;43.4648;43.1234;43.8692
564559;189;96;93;48.5899;45.2500;52.0376
539953;1831;906;925;41.6617;40.9128;42.3951
539970;385;189;196;43.5519;42.6481;44.4235
539988;312;161;151;42.6859;41.9472;43.4735
540013;3520;1696;1824;43.6784;41.5177;45.6875
540021;389;198;191;39.2044;39.1515;39.2592
564664;89;45;44;44.1404;44.1222;44.1591
564419;161;80;81;44.1708;45.5375;42.8210
540072;390;203;187;45.0923;42.6379;47.7567
540081;351;171;180;39.4174;37.4298;41.3056
540099;407;197;210;44.5049;43.7995;45.1667
513504;430;213;217;40.2837;38.9038;41.6382
540111;8960;4340;4620;41.7729;40.2675;43.1870
540129;893;437;456;44.2100;44.1064;44.3092
599298;158;73;85;42.5633;41.3493;43.6059
540145;557;273;284;43.7531;41.6978;45.7289
540153;430;210;220;44.4395;45.4571;43.4682
540170;334;178;156;41.5449;40.7022;42.5064
540188;267;140;127;41.7285;40.4214;43.1693
598381;376;213;163;42.6197;44.2324;40.5123
540218;1092;580;512;43.5375;42.7483;44.4316
564508;312;155;157;40.6346;39.3194;41.9331
598402;490;250;240;39.1184;39.0920;39.1458
540242;625;318;307;42.5352;41.8176;43.2785
564605;150;74;76;46.3667;45.2432;47.4605
564257;91;58;33;45.4341;44.7414;46.6515
540285;396;209;187;46.8182;44.8445;49.0241
513580;253;129;124;42.4605;38.4225;46.6613
540315;789;394;395;45.0095;43.7056;46.3101
540323;524;276;248;40.1584;40.1051;40.2177
564249;215;107;108;40.6395;40.4252;40.8519
540358;250;122;128;43.3440;41.5574;45.0469
540374;396;213;183;41.6970;41.8099;41.5656
540391;564;283;281;41.5266;41.2527;41.8025
540404;2255;1149;1106;39.7647;39.2076;40.3436
540439;945;470;475;41.4746;41.2766;41.6705
540447;460;238;222;44.7109;45.5294;43.8333
598461;330;176;154;41.4879;38.4261;44.9870
599204;132;59;73;39.6515;39.5000;39.7740
540498;1367;702;665;41.9236;40.2778;43.6609
513555;203;105;98;43.4113;41.3381;45.6327
529681;118;58;60;46.3475;45.1034;47.5500
540536;387;196;191;44.2364;43.7041;44.7827
540552;1109;564;545;42.6785;42.4770;42.8872
540579;181;92;89;43.2182;43.8587;42.5562
540587;136;71;65;44.7647;43.6690;45.9615
540625;620;303;317;41.1323;40.2327;41.9921
564346;216;111;105;41.1667;40.4459;41.9286
513521;192;97;95;40.8490;41.5515;40.1316
598411;481;234;247;44.2464;43.8504;44.6215
540714;1042;514;528;40.9702;40.3171;41.6061
540749;322;164;158;45.9969;44.9024;47.1329
540757;2155;1063;1092;42.1065;41.4304;42.7647
599751;88;50;38;38.1591;34.4800;43.0000
540781;793;416;377;40.4079;39.0216;41.9377
540790;604;293;311;41.6209;40.7969;42.3971
564478;269;134;135;41.9610;42.7388;41.1889
540811;762;402;360;44.6601;44.0771;45.3111
540820;459;224;235;42.3562;41.0000;43.6489
540846;658;337;321;41.1413;40.9955;41.2944
564524;196;96;100;46.8316;46.0000;47.6300
564222;60;35;25;42.7500;45.1571;39.3800
540889;1286;627;659;37.2722;37.3724;37.1768
540897;256;125;131;40.7578;38.4920;42.9198
540901;2065;1020;1045;41.6738;40.6647;42.6589
513571;190;95;95;39.0526;37.7316;40.3737
540935;1256;654;602;43.0040;40.7416;45.4618
540943;261;136;125;44.4042;41.5441;47.5160
540951;682;351;331;42.4076;39.9900;44.9713
540960;293;155;138;43.5034;42.9129;44.1667
598470;257;138;119;42.5389;40.7536;44.6092
598372;133;66;67;39.6579;40.4091;38.9179
541010;245;126;119;39.5571;38.0397;41.1639
541028;372;195;177;41.2258;39.6538;42.9576
541044;1350;688;662;42.6919;41.2994;44.1390
541052;642;306;336;41.4486;40.9837;41.8720
564214;110;53;57;37.7727;38.3868;37.2018
541087;538;273;265;43.3123;42.5147;44.1340
564486;1102;570;532;42.5372;41.5982;43.5432
541133;500;246;254;40.8160;40.3211;41.2953
539911;32503;15545;16958;43.9524;41.9565;45.7820
513547;338;152;186;39.9586;38.6974;40.9892
564389;190;107;83;41.4158;38.7897;44.8012
598488;210;108;102;43.9762;42.4630;45.5784
541206;835;412;423;41.5251;40.4078;42.6135
541231;4372;2163;2209;45.5014;43.2813;47.6752
541257;447;221;226;39.1085;39.6765;38.5531
541273;221;107;114;45.4774;44.4346;46.4561
541281;7029;3340;3689;44.7201;42.3874;46.8321
530573;2866;1432;1434;43.6793;42.2367;45.1199
564630;268;131;137;44.3657;43.7977;44.9088
541311;243;124;119;41.9527;41.8145;42.0966
541320;385;181;204;44.4221;44.7210;44.1569
541338;1503;753;750;40.1886;38.9502;41.4320
564583;134;64;70;41.3134;42.9531;39.8143
541371;381;186;195;38.4475;38.2366;38.6487
541389;486;240;246;39.2449;38.2417;40.2236
541397;661;353;308;43.3185;43.3612;43.2695
564273;113;61;52;40.5442;40.7295;40.3269
541419;351;185;166;39.2778;38.9162;39.6807
529664;50;23;27;37.9800;37.3261;38.5370
541427;661;353;308;41.9266;40.2507;43.8474
598429;443;236;207;42.1253;41.8051;42.4903
541451;285;143;142;37.5877;36.9615;38.2183
598330;107;49;58;41.1729;40.3776;41.8448
513539;179;87;92;45.6117;43.8908;47.2391
541508;703;370;333;41.8684;41.5892;42.1787
541516;665;327;338;41.1421;41.4847;40.8107
541524;384;196;188;44.6823;44.3520;45.0266
541541;671;337;334;42.1841;42.3635;42.0030
564362;156;80;76;43.6218;42.7500;44.5395
541567;320;160;160;38.8188;36.0250;41.6125
598437;136;68;68;44.4926;43.1029;45.8824
541583;349;165;184;42.9871;42.1242;43.7609
541591;828;429;399;43.9263;41.8683;46.1391
541613;324;168;156;45.9383;43.2381;48.8462
564320;132;61;71;44.8030;45.4016;44.2887
513512;308;155;153;42.8019;40.6548;44.9771
564338;71;34;37;45.9366;40.4412;50.9865
565423;65;28;37;41.4846;37.2500;44.6892
541672;209;100;109;47.9019;48.3100;47.5275
565041;133;79;54;44.7782;42.6646;47.8704
541699;896;472;424;43.5257;41.3983;45.8939
565181;209;102;107;39.5383;38.7353;40.3037
529711;81;43;38;45.1914;44.8023;45.6316
541729;422;192;230;42.9123;43.7188;42.2391
541737;489;262;227;39.6411;39.3740;39.9493
565202;79;40;39;45.3861;43.0250;47.8077
541761;245;135;110;46.4592;46.1296;46.8636
541770;599;303;296;42.2429;40.9653;43.5507
565334;164;85;79;42.5671;43.5235;41.5380
541818;667;339;328;40.9678;39.7065;42.2713
565270;140;71;69;45.9500;42.0211;49.9928
541834;1698;829;869;43.0277;41.3058;44.6703
565440;100;55;45;44.5100;43.5727;45.6556
565288;135;71;64;43.9148;42.8380;45.1094
541877;1051;525;526;42.3763;41.5229;43.2281
565199;156;87;69;39.2051;37.8908;40.8623
541893;809;402;407;42.8189;41.0448;44.5713
541907;573;285;288;38.7653;38.4789;39.0486
565385;102;52;50;44.0686;41.8269;46.4000
565351;137;71;66;41.1642;39.0211;43.4697
565369;80;43;37;42.2750;41.1512;43.5811
541940;271;135;136;41.8838;40.9593;42.8015
598500;114;59;55;45.8596;46.1949;45.5000
541966;442;219;223;42.5430;41.1849;43.8767
541974;623;317;306;41.7119;39.7618;43.7320
541982;673;318;355;44.5371;44.2642;44.7817
542008;120;67;53;46.9833;43.1567;51.8208
542016;665;332;333;41.5722;40.3645;42.7763
542032;1006;510;496;40.1561;39.7157;40.6089
542041;1882;924;958;42.5829;41.2511;43.8674
565377;98;54;44;37.6531;36.5370;39.0227
542067;446;232;214;44.5202;42.9095;46.2664
542075;310;150;160;42.5097;42.0467;42.9438
565466;193;97;96;40.9560;37.8196;44.1250
542105;908;453;455;43.1487;41.2241;45.0648
542113;633;305;328;41.3404;40.8508;41.7957
542121;813;406;407;42.4938;42.3547;42.6327
542130;425;220;205;41.3282;40.2273;42.5098
598585;93;50;43;46.6935;44.2800;49.5000
542164;5572;2737;2835;41.8112;40.0367;43.5243
542181;174;81;93;40.7471;38.4259;42.7688
542199;581;313;268;42.4380;40.1198;45.1455
542202;379;203;176;44.6240;43.6133;45.7898
542211;281;144;137;43.8665;41.7986;46.0401
544248;1050;544;506;43.8943;43.1324;44.7134
542229;274;140;134;43.6168;41.7929;45.5224
542237;265;125;140;47.6208;46.3640;48.7429
598577;67;29;38;48.3507;49.1897;47.7105
542253;212;108;104;44.3915;44.8796;43.8846
565261;213;105;108;41.5751;41.5571;41.5926
542270;315;161;154;44.3000;45.1025;43.4610
542288;137;74;63;45.9891;43.0000;49.5000
599760;161;88;73;45.4193;44.4545;46.5822
541656;15709;7533;8176;44.2638;42.6009;45.7960
598526;1078;573;505;44.3061;43.2714;45.4802
542326;757;380;377;42.2015;41.4263;42.9828
542334;997;526;471;40.0717;38.6122;41.7017
565504;86;41;45;43.4302;43.7195;43.1667
542351;1343;684;659;43.9952;41.6491;46.4302
542369;262;138;124;42.1260;41.1232;43.2419
542377;1255;615;640;40.1829;39.8870;40.4672
542385;156;78;78;47.1603;44.2308;50.0897
542415;730;364;366;41.9110;42.2445;41.5792
565407;76;34;42;38.8289;39.6765;38.1429
542431;308;156;152;43.3571;41.5577;45.2039
542458;350;178;172;42.6400;40.5618;44.7907
542466;537;273;264;45.5782;45.3791;45.7841
542474;561;292;269;39.8993;37.5651;42.4331
598496;163;88;75;43.3589;41.5909;45.4333
565326;56;32;24;41.8929;40.9375;43.1667
542504;157;77;80;43.9076;44.0325;43.7875
542512;491;235;256;44.2006;43.1383;45.1758
565512;70;36;34;46.3857;40.8333;52.2647
542563;283;140;143;44.2173;43.1714;45.2413
529699;63;29;34;54.0079;49.2241;58.0882
565130;133;65;68;41.0639;39.6846;42.3824
542598;310;157;153;43.0710;39.9459;46.2778
542601;322;169;153;42.0839;42.0680;42.1013
542610;559;281;278;44.1637;42.9448;45.3957
598518;115;58;57;36.3783;37.3966;35.3421
535826;963;486;477;37.0327;37.2428;36.8187
536156;106;51;55;40.3962;36.1275;44.3545
544272;1595;766;829;42.3345;41.1736;43.4071
544281;4165;2034;2131;41.4649;40.0895;42.7778
535681;136;71;65;44.2426;42.7394;45.8846
544299;1947;937;1010;38.6567;39.0454;38.2960
535401;203;98;105;44.5000;43.6939;45.2524
551490;253;129;124;39.9822;38.7403;41.2742
536059;172;86;86;40.1395;40.9535;39.3256
535541;295;139;156;41.2390;41.3849;41.1090
544329;382;200;182;37.8298;36.4300;39.3681
598976;56;25;31;38.3036;39.4200;37.4032
544256;94463;45310;49153;43.0786;41.3775;44.6468
551503;260;121;139;42.6577;40.8306;44.2482
535249;336;169;167;38.5030;37.1213;39.9012
544361;547;271;276;43.3154;42.3745;44.2391
535206;2662;1306;1356;44.2149;42.4992;45.8673
536199;123;65;58;41.5488;40.3308;42.9138
544388;1744;887;857;41.5356;40.0851;43.0368
535664;310;155;155;42.2581;40.7839;43.7323
544400;479;247;232;41.6608;39.1397;44.3448
535958;330;167;163;39.3273;38.4701;40.2055
549371;245;119;126;47.5408;47.3151;47.7540
544426;1713;874;839;39.1083;38.0847;40.1746
535788;410;220;190;43.3098;43.3818;43.2263
544442;1630;833;797;39.2773;38.9430;39.6267
544451;329;179;150;43.5243;41.7123;45.6867
535575;108;61;47;42.2963;39.9918;45.2872
536075;185;95;90;39.3541;40.0474;38.6222
598593;186;101;85;42.5000;40.8663;44.4412
535851;151;72;79;42.7450;42.3333;43.1203
598607;443;234;209;38.0959;36.5128;39.8684
544485;5419;2651;2768;41.6886;40.7127;42.6232
544493;1606;807;799;38.7397;38.3823;39.1008
536105;110;48;62;46.0727;50.2292;42.8548
544515;1498;794;704;42.9866;41.7922;44.3338
544523;892;459;433;40.5717;39.4020;41.8118
535524;163;82;81;44.9969;46.4390;43.5370
535460;102;46;56;39.5196;40.2391;38.9286
544540;204;103;101;42.7059;42.8495;42.5594
544558;1561;783;778;43.3629;43.1028;43.6247
535753;592;306;286;39.5726;39.3627;39.7972
535613;132;63;69;38.3636;38.1032;38.6014
535907;244;125;119;40.0902;36.2520;44.1218
544591;720;354;366;43.0986;42.4124;43.7623
544612;378;193;185;43.0185;42.3342;43.7324
544639;1024;502;522;43.0566;42.7211;43.3793
535761;376;190;186;38.2766;39.4947;37.0323
535982;293;151;142;41.9130;40.7583;43.1408
544663;2431;1184;1247;41.2363;40.8184;41.6331
535877;352;184;168;41.0966;41.1630;41.0238
529729;129;59;70;40.1899;40.7542;39.7143
544736;2476;1234;1242;40.6975;39.4838;41.9034
544744;413;208;205;40.1755;40.1971;40.1537
535800;516;271;245;41.1822;40.6919;41.7245
544761;649;322;327;40.7049;40.0124;41.3869
544779;4426;2200;2226;41.7741;40.2136;43.3163
544795;2553;1244;1309;39.4471;39.0482;39.8262
544809;726;395;331;42.1612;40.1354;44.5785
535940;208;114;94;43.9231;44.3246;43.4362
544817;418;223;195;39.7153;40.9484;38.3051
598615;86;42;44;36.7209;34.3571;38.9773
535842;106;49;57;43.7830;45.3980;42.3947
535281;299;144;155;40.6472;41.0486;40.2742
535371;222;109;113;40.5450;41.1972;39.9159
544825;365;178;187;41.2425;40.0730;42.3556
535435;350;174;176;44.2629;43.6207;44.8977
535648;764;372;392;41.0746;40.4355;41.6811
544868;2531;1284;1247;42.9642;41.7500;44.2145
544884;857;419;438;40.5187;40.0394;40.9772
544892;798;403;395;41.5952;40.9566;42.2468
535231;175;90;85;40.7000;39.8333;41.6176
535699;284;153;131;42.9789;42.6046;43.4160
535991;656;326;330;41.4299;41.0736;41.7818
535176;257;132;125;43.1654;43.2121;43.1160
535346;419;221;198;42.8198;41.1063;44.7323
544965;179;92;87;43.0642;41.1630;45.0747
544973;1299;646;653;36.3591;35.4489;37.2596
544981;2536;1259;1277;43.6569;43.0695;44.2361
545007;927;473;454;40.4579;40.5148;40.3987
545015;516;253;263;40.9787;40.4684;41.4696
545023;686;347;339;41.8878;41.0735;42.7212
545066;2716;1376;1340;37.7585;37.6490;37.8709
545074;1304;638;666;39.9410;39.1959;40.6547
545082;504;239;265;41.3254;42.1862;40.5491
536032;65;39;26;42.3154;40.6026;44.8846
545091;225;112;113;42.7889;41.1071;44.4558
545104;587;286;301;39.3876;39.2063;39.5598
545121;1423;688;735;41.4578;40.9128;41.9680
545139;919;480;439;39.4837;37.8396;41.2813
545155;840;449;391;43.5786;40.3129;47.3286
545171;5207;2608;2599;41.8701;41.0261;42.7170
545201;7960;3923;4037;41.8175;40.5502;43.0489
535494;497;256;241;40.7616;40.4336;41.1100
545228;2234;1114;1120;38.8456;38.1732;39.5143
535737;603;311;292;38.7239;38.7540;38.6918
535893;456;240;216;38.7917;38.1167;39.5417
535915;41;24;17;44.3049;43.0000;46.1471
545261;803;385;418;39.0766;40.2065;38.0359
535796;422;216;206;40.0664;40.2917;39.8301
545287;1108;582;526;42.7428;41.3660;44.2662
545317;388;195;193;40.9330;41.1000;40.7642
536016;476;241;235;42.4580;41.6286;43.3085
599778;50;22;28;40.4800;43.4545;38.1429
545341;3562;1751;1811;43.6875;42.0306;45.2896
535591;255;128;127;41.3392;41.0703;41.6102
545368;419;213;206;42.3401;41.3498;43.3641
545376;352;172;180;41.3381;41.3081;41.3667
545384;637;318;319;41.6052;41.7610;41.4498
545406;1458;750;708;41.7689;41.3640;42.1977
545414;816;393;423;42.6789;41.0827;44.1619
536253;307;167;140;40.6075;41.3204;39.7571
545422;0;0;0;0.0000;0.0000;0.0000
545431;1076;576;500;42.0437;40.1024;44.2800
545449;559;298;261;40.0689;37.4430;43.0670
545457;839;424;415;42.6359;42.3656;42.9120
545392;12981;6328;6653;43.1992;41.8418;44.4902
545465;1377;720;657;39.5341;38.7347;40.4102
545473;1342;635;707;39.1498;38.8228;39.4434
545481;1304;660;644;42.5928;41.1773;44.0435
545490;1107;530;577;42.1305;42.4132;41.8709
545503;460;235;225;41.1130;39.7426;42.5444
545511;2080;1060;1020;45.9072;44.0283;47.8598
545520;851;440;411;40.0899;38.4068;41.8917
536229;99;50;49;36.8737;37.9000;35.8265
545546;1250;627;623;41.7584;41.2974;42.2223
545554;1857;904;953;38.1554;38.1527;38.1579
545562;7282;3805;3477;41.5520;39.7205;43.5564
545571;2896;1442;1454;40.8232;39.6789;41.9580
545597;667;338;329;40.2871;40.6598;39.9043
545601;1597;807;790;44.1193;42.5359;45.7367
545619;1380;703;677;38.0928;37.8300;38.3656
536296;173;83;90;42.8931;45.6566;40.3444
545627;463;233;230;40.3704;40.2983;40.4435
598623;259;124;135;38.5270;39.3145;37.8037
545643;467;245;222;43.1660;41.4102;45.1036
513661;416;214;202;40.8726;40.1215;41.6683
545660;556;291;265;40.2572;39.6237;40.9528
545694;239;138;101;39.3954;38.6304;40.4406
500194;217;126;91;37.8963;38.7857;36.6648
545716;219;114;105;51.9566;53.7193;50.0429
545724;698;361;337;37.0817;37.9903;36.1083
545732;196;96;100;41.6888;41.0833;42.2700
545767;373;203;170;41.0013;40.3719;41.7529
545775;467;246;221;39.3737;39.6911;39.0204
545805;375;192;183;41.5987;40.2917;42.9699
536245;328;158;170;42.6159;43.0316;42.2294
551538;428;231;197;43.8785;43.0368;44.8655
545813;234;118;116;42.5855;42.8051;42.3621
545821;3902;1945;1957;43.1343;42.1463;44.1162
545830;3866;1986;1880;40.3681;39.1878;41.6149
536300;157;77;80;40.2771;41.5000;39.1000
545848;2617;1323;1294;40.1156;39.2256;41.0255
545864;792;382;410;42.0745;41.7932;42.3366
545872;426;222;204;40.4977;38.2162;42.9804
536237;103;50;53;37.3544;36.9400;37.7453
562726;110;61;49;43.0545;41.2377;45.3163
562548;119;59;60;40.2059;38.0932;42.2833
561053;181;91;90;44.3232;41.9945;46.6778
561711;459;243;216;40.6874;42.1091;39.0880
562742;107;56;51;37.6215;35.7679;39.6569
507733;126;64;62;49.8413;48.5781;51.1452
546020;212;113;99;41.6840;39.2965;44.4091
546038;694;360;334;40.6383;39.8250;41.5150
509191;192;103;89;44.0625;43.2282;45.0281
546054;513;263;250;43.1881;41.7738;44.6760
509116;210;112;98;41.4905;40.8750;42.1939
546089;3575;1826;1749;41.0116;39.7251;42.3548
546097;930;456;474;44.6624;44.2281;45.0802
546101;719;384;335;43.4374;43.4375;43.4373
561703;479;253;226;41.3768;40.0573;42.8540
546127;7288;3520;3768;44.5644;43.1821;45.8556
546143;597;309;288;44.3090;42.5421;46.2049
546151;741;370;371;43.0816;41.2135;44.9447
529753;70;38;32;43.3429;41.5263;45.5000
562416;44;25;19;42.2045;39.7400;45.4474
562467;394;202;192;36.2132;36.6238;35.7813
562602;154;80;74;39.6948;40.1750;39.1757
562840;390;192;198;37.8846;36.7344;39.0000
507610;82;38;44;42.8902;43.2895;42.5455
560987;50;24;26;43.9800;43.0833;44.8077
562815;216;117;99;40.2870;39.5598;41.1465
509141;352;167;185;42.9261;43.8713;42.0730
562637;152;68;84;44.2697;43.9118;44.5595
562696;58;28;30;41.1379;41.6786;40.6333
562807;196;108;88;46.8776;42.8148;51.8636
562386;367;185;182;42.0886;41.5595;42.6264
546291;208;103;105;43.5048;40.6359;46.3190
546305;87;45;42;40.8218;42.3667;39.1667
598658;111;54;57;42.0676;40.6852;43.3772
562785;79;42;37;43.0190;40.6429;45.7162
546364;597;297;300;42.5519;41.5135;43.5800
546381;234;117;117;46.6538;44.5085;48.7991
561061;171;84;87;37.4181;40.0476;34.8793
562319;133;72;61;47.2293;45.7500;48.9754
546402;420;211;209;39.6405;39.9218;39.3565
562831;78;40;38;42.9103;42.6000;43.2368
546445;338;170;168;39.2811;36.0059;42.5952
546461;1951;971;980;47.4185;46.1704;48.6551
546500;1094;546;548;43.0795;41.3407;44.8120
562769;127;63;64;40.5945;40.8810;40.3125
545881;21419;10189;11230;43.5204;41.8592;45.0276
562491;104;55;49;40.5192;39.5000;41.6633
598631;70;32;38;46.8571;45.3125;48.1579
546542;2206;1140;1066;42.7511;41.6579;43.9203
562688;166;81;85;46.7048;47.4877;45.9588
509108;300;153;147;43.1800;42.7092;43.6701
508357;160;93;67;43.7438;42.6828;45.2164
546615;1472;743;729;43.4688;42.3627;44.5960
546623;556;296;260;41.1781;40.7196;41.7000
546666;655;343;312;42.3443;40.4213;44.4583
546674;1782;867;915;43.6829;41.9729;45.3033
508501;420;204;216;41.6095;40.5686;42.5926
546712;516;264;252;42.4341;41.2689;43.6548
546798;3299;1651;1648;43.3760;42.1124;44.6420
562734;135;69;66;41.6185;41.0217;42.2424
546801;2277;1107;1170;44.2962;43.4440;45.1026
562360;338;178;160;41.3432;41.3820;41.3000
546844;681;364;317;43.1887;41.7885;44.7965
562475;189;96;93;47.4524;45.5521;49.4140
507717;475;255;220;38.9358;37.6490;40.4273
546917;500;250;250;43.0300;41.3480;44.7120
561070;127;69;58;45.2244;45.3116;45.1207
509078;452;223;229;43.4358;41.8946;44.9367
507628;175;89;86;46.6543;47.5225;45.7558
546968;603;320;283;43.1633;40.7031;45.9452
562459;114;55;59;41.9035;43.6091;40.3136
562670;117;58;59;44.7308;47.7069;41.8051
562653;83;39;44;45.7771;49.8077;42.2045
546992;491;260;231;43.0682;40.3500;46.1277
561088;267;139;128;44.2116;41.9101;46.7109
547069;644;345;299;40.4581;41.1580;39.6505
507784;171;90;81;49.9327;45.4778;54.8827
547085;609;322;287;40.0484;39.3385;40.8449
508004;235;111;124;39.0617;39.1577;38.9758
560995;63;32;31;50.7857;49.0625;52.5645
547166;2367;1205;1162;44.4662;43.7000;45.2608
561045;111;51;60;43.3108;43.0294;43.5500
562378;203;104;99;48.3670;44.2885;52.6515
547204;532;263;269;41.8947;42.4240;41.3773
547212;452;240;212;44.5863;43.6125;45.6887
547221;875;413;462;42.9480;42.8317;43.0519
547239;1440;713;727;43.6701;42.0091;45.2992
547247;441;216;225;47.9195;47.2963;48.5178
508152;564;286;278;44.3989;42.4056;46.4496
547263;2289;1147;1142;44.5048;43.2036;45.8117
547280;3530;1728;1802;44.7014;43.5347;45.8202
561029;132;64;68;47.0682;47.9375;46.2500
562327;334;165;169;37.7156;37.3667;38.0562
547336;8217;3929;4288;45.1866;43.3279;46.8897
507644;70;35;35;47.6429;47.0714;48.2143
562599;223;114;109;43.6256;43.7632;43.4817
561037;76;43;33;44.7895;43.9651;45.8636
507652;85;44;41;40.4059;42.0227;38.6707
598640;46;25;21;49.5870;46.6200;53.1190
547441;720;379;341;41.0681;39.4657;42.8490
562629;106;57;49;49.6698;50.2368;49.0102
508683;78;36;42;42.4487;38.3333;45.9762
507695;109;55;54;43.3807;45.3364;41.3889
547468;258;124;134;42.6938;44.0081;41.4776
529761;98;48;50;42.6531;41.3750;43.8800
562424;60;30;30;34.9500;31.1667;38.7333
549258;918;487;431;43.3758;42.2372;44.6624
549266;1312;650;662;45.6113;44.9985;46.2130
598780;213;102;111;43.1620;42.9118;43.3919
562122;193;103;90;42.5207;39.5388;45.9333
549291;363;183;180;42.8554;42.2760;43.4444
549304;295;145;150;43.3373;42.0241;44.6067
549321;151;79;72;46.5662;45.9304;47.2639
549339;966;489;477;44.8613;43.3262;46.4350
549347;1259;637;622;40.8654;40.7543;40.9791
549363;939;494;445;40.4169;39.4798;41.4573
562301;235;126;109;40.3043;40.9603;39.5459
549380;570;293;277;46.3070;45.4078;47.2581
549398;278;153;125;41.1619;38.2908;44.6760
561525;145;75;70;38.9966;36.6467;41.5143
549410;271;146;125;43.9428;44.4932;43.3000
549428;482;251;231;44.9378;43.0020;47.0411
549452;1078;574;504;41.3135;40.8467;41.8452
549479;336;165;171;40.5030;40.2515;40.7456
562084;128;66;62;38.3906;37.8182;39.0000
549487;717;376;341;40.3480;39.9814;40.7522
549495;619;314;305;42.0509;40.8694;43.2672
549509;381;189;192;45.9147;45.2513;46.5677
549517;1451;703;748;45.7771;45.3777;46.1524
561550;51;23;28;46.0882;47.7609;44.7143
549525;206;107;99;42.6893;42.9206;42.4394
562181;169;85;84;46.6538;47.6059;45.6905
509752;104;53;51;42.5288;44.1415;40.8529
549541;187;99;88;44.6123;42.4394;47.0568
598801;116;58;58;42.2672;41.1552;43.3793
549568;287;133;154;41.4164;44.8985;38.4091
549576;8280;3994;4286;46.3600;44.3873;48.1983
562149;34;18;16;58.1176;49.8889;67.3750
549584;1248;633;615;41.0841;39.6833;42.5260
549592;1622;815;807;43.7639;41.8546;45.6921
549606;268;134;134;41.1530;40.9254;41.3806
549614;94;47;47;41.1383;42.9043;39.3723
562157;106;56;50;45.0377;44.0357;46.1600
549657;135;78;57;49.8481;47.6538;52.8509
529877;61;28;33;47.1393;45.5000;48.5303
562190;136;74;62;43.0294;42.3108;43.8871
549681;271;126;145;47.6624;48.1984;47.1966
598828;138;79;59;42.5362;39.1709;47.0424
549703;343;166;177;42.0569;40.5723;43.4492
549711;365;190;175;44.3493;43.5632;45.2029
562254;179;91;88;42.1536;43.5549;40.7045
549240;30415;14627;15788;42.9870;41.2403;44.6053
549754;375;202;173;43.5080;44.2673;42.6214
561509;68;35;33;54.2206;56.4143;51.8939
549771;4808;2434;2374;43.9266;42.4655;45.4246
561517;144;79;65;44.7917;41.5886;48.6846
509621;565;281;284;42.6735;41.9626;43.3768
549797;288;144;144;43.2361;43.0208;43.4514
549801;552;274;278;41.9547;41.0839;42.8129
562068;220;101;119;42.8864;41.6881;43.9034
549827;388;189;199;44.9433;46.0820;43.8618
549843;1343;671;672;45.4382;43.9560;46.9182
549851;290;144;146;43.6862;43.6667;43.7055
549860;364;200;164;43.9176;41.7950;46.5061
549878;277;145;132;45.5794;42.9897;48.4242
529885;96;50;46;50.1563;50.3000;50.0000
549932;169;92;77;43.8077;41.6087;46.4351
562271;121;52;69;42.5909;44.9423;40.8188
562211;184;91;93;51.7283;52.6319;50.8441
549975;218;118;100;42.7982;42.7373;42.8700
598844;223;109;114;39.9036;36.7477;42.9211
598852;143;65;78;46.6119;46.4231;46.7692
562289;82;46;36;52.3415;51.8261;53.0000
549991;316;165;151;44.6709;43.4152;46.0430
550001;177;86;91;41.9520;42.0349;41.8736
550027;788;402;386;44.5964;43.5299;45.7073
550035;349;181;168;45.0244;44.0193;46.1071
550043;155;85;70;42.9129;40.8647;45.4000
550060;303;160;143;42.7277;41.6563;43.9266
562165;208;110;98;43.5577;42.1909;45.0918
598861;258;133;125;43.6899;41.8383;45.6600
537241;133;60;73;34.8759;36.6000;33.4589
550116;328;160;168;41.1829;39.3938;42.8869
537527;47;23;24;52.3723;51.6739;53.0417
545902;269;144;125;42.8941;43.9583;41.6680
550124;342;186;156;41.5292;40.4516;42.8141
561576;90;48;42;46.4333;46.8542;45.9524
537519;286;150;136;41.4895;39.0933;44.1324
550159;268;132;136;43.7910;42.4242;45.1176
550167;1624;803;821;43.0049;41.8238;44.1602
537187;95;53;42;44.8158;43.2358;46.8095
550183;397;204;193;37.6688;35.4902;39.9715
537144;94;41;53;39.4255;40.3537;38.7075
550205;358;171;187;43.2291;42.3421;44.0401
550221;486;238;248;42.4383;41.7269;43.1210
550230;1452;726;726;40.6949;39.5289;41.8609
550248;335;183;152;42.0194;41.8333;42.2434
550264;562;284;278;39.1815;39.2289;39.1331
537420;155;81;74;45.6226;45.6605;45.5811
537136;46;23;23;55.6087;52.6304;58.5870
561673;93;58;35;46.0161;44.2931;48.8714
550329;496;268;228;41.2137;40.6269;41.9035
563978;92;48;44;45.5217;46.9583;43.9545
550337;139;76;63;47.0755;44.8026;49.8175
550345;310;167;143;39.3548;39.1168;39.6329
561649;147;73;74;42.0374;43.0342;41.0541
550353;736;357;379;41.3995;40.9426;41.8298
550361;2119;1153;966;43.2839;42.5009;44.2184
537071;200;95;105;44.6200;44.8368;44.4238
537322;39;21;18;43.9872;45.9762;41.6667
537381;163;90;73;39.9663;39.2111;40.8973
550418;636;347;289;42.6274;40.9726;44.6142
550426;370;192;178;41.1919;40.4427;42.0000
550434;576;290;286;39.8611;40.5241;39.1888
550396;194;95;99;41.5619;40.3526;42.7222
550442;2579;1275;1304;42.2107;41.0169;43.3781
529893;92;49;43;38.8478;34.1122;44.2442
550451;440;228;212;45.7477;43.3114;48.3679
561568;91;49;42;44.9286;41.8673;48.5000
537365;63;32;31;40.8175;43.4375;38.1129
537543;143;72;71;36.6608;39.0694;34.2183
550094;10840;5244;5596;43.3229;41.4468;45.0810
550485;147;73;74;46.3776;44.4452;48.2838
550515;1153;575;578;45.4228;43.8670;46.9706
550523;205;116;89;43.1244;44.5345;41.2865
550531;430;225;205;39.0140;38.5356;39.5390
550540;1263;636;627;42.4177;40.5283;44.3341
550558;604;315;289;41.7947;41.0397;42.6176
550574;425;225;200;41.2059;37.9044;44.9200
550582;319;172;147;43.0549;42.6163;43.5680
550604;125;64;61;40.7240;40.1406;41.3361
537535;87;50;37;42.3966;41.9800;42.9595
550621;1457;759;698;44.9544;43.6014;46.4255
550647;7440;3663;3777;42.7621;41.4727;44.0126
550655;509;259;250;41.6375;39.4537;43.9000
550663;1716;845;871;41.1416;40.3604;41.8995
550671;3787;1896;1891;41.6693;40.8339;42.5069
529915;66;31;35;41.9091;41.0484;42.6714
550680;332;172;160;44.7892;44.5930;45.0000
537195;66;35;31;50.3333;49.5571;51.2097
550698;317;159;158;44.4558;44.8145;44.0949
550701;322;168;154;41.9037;39.7083;44.2987
550728;1740;860;880;43.5667;42.3547;44.7511
529923;120;60;60;41.4917;42.8667;40.1167
550761;112;64;48;36.6518;38.5156;34.1667
537209;311;160;151;40.4196;39.7125;41.1689
550809;1600;786;814;42.7669;41.7697;43.7297
550817;986;507;479;44.8174;43.1982;46.5313
598895;368;204;164;41.6875;38.3971;45.7805
550833;195;106;89;43.6641;41.6415;46.0730
550850;6573;3204;3369;44.4226;42.2385;46.4997
537063;51;30;21;46.4608;43.8000;50.2619
530018;68;36;32;46.1618;41.7778;51.0938
560171;45;29;16;41.7222;44.6034;36.5000
529966;175;88;87;42.1171;41.8750;42.3621
550906;495;266;229;40.7283;39.8346;41.7664
510068;196;95;101;44.1173;42.3526;45.7772
550922;922;482;440;41.1139;39.5000;42.8818
550949;203;102;101;40.7562;38.3824;43.1535
550957;902;461;441;43.1386;43.2180;43.0556
550965;458;216;242;42.6070;43.0648;42.1983
550981;276;141;135;43.1703;43.1312;43.2111
551015;360;189;171;43.6917;42.3571;45.1667
560219;192;100;92;39.9948;39.7800;40.2283
551023;239;131;108;46.7427;44.6069;49.3333
560243;138;73;65;42.7246;43.3767;41.9923
551040;319;152;167;41.4530;42.1776;40.7934
551597;137;66;71;38.1642;36.8939;39.3451
561690;42;23;19;37.0476;32.8043;42.1842
536628;95;53;42;44.5526;46.8396;41.6667
536881;302;157;145;43.4901;41.5637;45.5759
536369;73;41;32;42.1438;42.9634;41.0938
551104;156;77;79;44.7179;47.3182;42.1835
551121;154;82;72;44.0519;43.5732;44.5972
551139;405;211;194;40.5988;37.8602;43.5773
529982;198;114;84;41.0152;39.1930;43.4881
536903;42;24;18;51.5714;48.9583;55.0556
551155;264;130;134;42.2083;40.2769;44.0821
551163;205;107;98;38.7488;34.4626;43.4286
551180;377;198;179;44.0889;44.1162;44.0587
536946;85;44;41;48.8529;45.7500;52.1829
551201;1351;668;683;43.3075;42.3353;44.2584
560405;144;74;70;44.4792;44.8784;44.0571
536601;150;73;77;50.0267;51.5548;48.5779
536342;98;49;49;45.6327;44.3367;46.9286
551261;217;104;113;45.2604;45.6635;44.8894
536806;157;75;82;45.2643;41.6067;48.6098
536954;75;38;37;41.5533;42.2105;40.8784
536555;141;80;61;44.2589;43.5000;45.2541
560391;37;23;14;41.2027;39.7174;43.6429
536750;113;56;57;38.1726;38.3214;38.0263
598950;101;45;56;41.4802;41.2333;41.6786
560197;55;29;26;43.1182;44.7759;41.2692
551333;471;236;235;41.4809;40.2839;42.6830
536831;87;43;44;43.7299;44.3372;43.1364
551341;278;145;133;42.4317;40.0241;45.0564
551350;703;380;323;44.7390;41.9816;47.9830
536822;120;57;63;43.6500;43.7105;43.5952
536466;299;110;189;41.8177;37.0364;44.6005
551384;714;342;372;40.9902;39.8129;42.0726
551392;286;141;145;41.2133;39.9823;42.4103
536415;52;29;23;33.7692;32.1207;35.8478
536539;76;37;39;38.3289;38.7703;37.9103
551414;270;145;125;41.0704;42.1345;39.8360
536563;230;113;117;44.5565;43.9425;45.1496
560278;255;128;127;44.1588;42.5078;45.8228
551473;281;143;138;46.4039;47.5559;45.2101
536644;157;75;82;43.1815;44.2600;42.1951
536474;107;59;48;44.9299;43.6186;46.5417
536725;109;51;58;40.9495;42.9314;39.2069
551520;306;158;148;42.4379;42.5570;42.3108
536962;234;122;112;41.6752;42.1230;41.1875
560201;93;49;44;49.0699;45.4184;53.1364
551554;345;163;182;43.3580;41.5798;44.9505
551562;653;386;267;43.7159;44.6425;42.3764
551571;112;60;52;40.7232;35.9500;46.2308
598887;78;38;40;42.4615;41.7105;43.1750
536911;78;40;38;39.6154;39.6250;39.6053
551619;319;155;164;42.4937;41.5387;43.3963
551627;325;167;158;42.6815;40.8353;44.6329
536792;87;43;44;41.6379;41.5698;41.7045
551635;252;132;120;43.7659;41.2576;46.5250
536547;122;62;60;44.5902;45.4516;43.7000
551643;465;228;237;43.1903;43.2500;43.1329
536423;44;25;19;37.6364;36.5400;39.0789
551660;1348;654;694;39.8605;39.0168;40.6556
551678;664;348;316;42.9849;43.3592;42.5728
536865;221;110;111;45.4774;45.0182;45.9324
536849;465;247;218;40.8849;40.6012;41.2064
551716;1252;615;637;43.4920;42.6691;44.2865
598909;69;32;37;45.4855;39.1250;50.9865
551741;242;116;126;38.9008;38.6810;39.1032
536776;158;85;73;39.1139;36.6176;42.0205
551759;302;146;156;40.0894;38.0342;42.0128
530034;375;184;191;36.8893;37.0598;36.7251
550787;22646;10855;11791;43.6128;41.6020;45.4640
551775;187;101;86;45.7139;43.0050;48.8953
536784;131;62;69;44.0573;42.6290;45.3406
551791;902;468;434;42.0632;41.1389;43.0599
551830;324;173;151;43.4753;42.9624;44.0629
536920;215;107;108;43.6070;44.2850;42.9352
551856;824;397;427;44.8167;43.2204;46.3009
536598;243;123;120;43.3107;40.8821;45.8000
536512;197;90;107;40.5558;41.6444;39.6402
551899;321;157;164;42.6651;44.1624;41.2317
536679;77;43;34;43.9416;44.2209;43.5882
536695;96;46;50;52.0104;50.9130;53.0200
563951;62;33;29;47.0323;43.8636;50.6379
551937;113;54;59;48.2522;48.9815;47.5847
536890;123;63;60;48.2236;47.9603;48.5000
536504;51;28;23;53.1471;52.6071;53.8043
536741;168;86;82;44.1667;44.0465;44.2927
551953;7028;3552;3476;42.6164;41.0158;44.2520
551961;550;273;277;42.0727;41.9505;42.1931
551970;3014;1467;1547;43.8762;42.3923;45.2835
551988;335;163;172;41.5000;40.1380;42.7907
536482;63;33;30;47.7063;42.7424;53.1667
536873;63;32;31;47.5317;46.7500;48.3387
563251;140;74;66;38.4929;37.4865;39.6212
563366;79;49;30;43.8291;43.5816;44.2333
552054;5016;2487;2529;44.7646;42.6685;46.8258
560448;203;98;105;42.0123;42.7449;41.3286
552097;233;118;115;44.4485;43.9831;44.9261
552101;718;362;356;38.9610;39.0331;38.8876
552127;46;23;23;54.2609;49.7609;58.7609
552135;226;111;115;40.4646;41.0225;39.9261
552143;374;191;183;46.1364;43.4005;48.9918
563722;83;42;41;47.8735;47.5000;48.2561
552208;412;200;212;44.1845;41.9350;46.3066
563650;161;81;80;45.4193;44.4753;46.3750
552224;102;55;47;54.1569;53.4091;55.0319
552241;834;425;409;44.7494;42.9282;46.6418
560529;134;78;56;44.9925;42.9231;47.8750
563765;157;77;80;47.5127;47.1104;47.9000
552275;241;126;115;47.7199;47.9841;47.4304
552283;810;405;405;41.0519;41.5099;40.5938
552291;164;79;85;35.9451;37.3101;34.6765
563307;219;113;106;43.6187;41.3053;46.0849
563625;73;42;31;44.5137;42.8333;46.7903
560481;150;73;77;48.3067;47.2808;49.2792
552321;380;185;195;41.6974;43.0189;40.4436
598992;97;44;53;48.5928;45.4091;51.2358
562904;129;68;61;45.4767;47.0735;43.6967
552453;111;61;50;43.0405;39.7295;47.0800
552461;1765;891;874;42.0773;41.2598;42.9108
552470;488;248;240;44.2930;40.6411;48.0667
563145;151;79;72;42.2881;44.9937;39.3194
552496;2490;1212;1278;41.5305;39.9340;43.0446
562963;86;44;42;44.9767;41.4091;48.7143
552534;2027;1032;995;43.2055;42.1143;44.3372
530042;78;36;42;47.7692;46.6944;48.6905
563986;657;333;324;40.5137;39.7883;41.2593
599280;125;70;55;44.3160;44.3286;44.3000
552585;782;397;385;41.8031;40.8602;42.7753
562955;88;40;48;41.9432;42.0000;41.8958
560634;104;53;51;45.9038;48.2925;43.4216
563030;158;79;79;39.9684;40.2975;39.6392
563544;116;59;57;43.1379;44.0593;42.1842
563587;179;101;78;42.5168;41.5198;43.8077
552666;1824;898;926;42.9797;42.1759;43.7592
562866;126;65;61;47.0556;45.3923;48.8279
563234;167;86;81;41.0868;39.5000;42.7716
599255;99;47;52;43.0152;41.1596;44.6923
552704;2705;1339;1366;42.6752;41.5956;43.7335
552712;131;66;65;43.0115;42.7273;43.3000
552721;409;192;217;42.2848;43.8229;40.9240
549631;739;378;361;42.5474;41.2778;43.8767
559016;97;55;42;40.6031;41.5182;39.4048
552747;301;160;141;39.6894;36.4625;43.3511
552763;325;166;159;39.6846;39.3614;40.0220
563455;186;96;90;43.9624;44.8333;43.0333
552798;225;111;114;42.0733;41.9865;42.1579
552801;1408;709;699;42.8871;41.5931;44.1996
552828;4328;2140;2188;41.1391;40.0883;42.1668
560553;56;26;30;46.8750;47.3846;46.4333
552852;78;42;36;44.2179;41.7143;47.1389
552861;113;56;57;43.4735;41.3393;45.5702
552895;343;176;167;39.5612;39.1818;39.9611
563374;107;60;47;51.5374;48.7333;55.1170
552917;496;255;241;43.4536;42.4059;44.5622
552925;227;123;104;44.6850;41.9146;47.9615
563196;63;35;28;46.0556;41.9000;51.2500
552933;387;199;188;42.9186;42.5000;43.3617
552941;165;88;77;43.6212;42.7955;44.5649
552976;200;97;103;41.4350;44.2010;38.8301
552992;750;384;366;43.0800;41.8698;44.3497
560626;95;49;46;45.6263;46.0714;45.1522
553018;552;296;256;43.0036;41.9730;44.1953
560511;88;49;39;41.7500;42.5408;40.7564
553034;288;135;153;41.1319;40.3370;41.8333
599115;335;167;168;39.7448;39.3862;40.1012
599263;156;80;76;38.2949;38.1000;38.5000
553069;7221;3513;3708;45.9024;44.0702;47.6383
553077;491;241;250;43.3310;42.5083;44.1240
553085;172;85;87;42.4767;41.5706;43.3621
560669;147;85;62;41.3639;39.1118;44.4516
599026;141;67;74;42.4574;42.9179;42.0405
599042;494;245;249;40.6154;39.9163;41.3032
553123;370;180;190;46.5216;45.8611;47.1474
553131;6907;3335;3572;45.0930;43.1516;46.9057
553140;569;290;279;43.2188;41.9552;44.5323
553166;769;399;370;41.2165;41.7732;40.6162
553174;296;149;147;42.8041;41.3054;44.3231
553182;336;177;159;41.2470;40.6638;41.8962
563170;57;32;25;42.7281;37.5000;49.4200
553204;348;184;164;46.9138;47.4130;46.3537
552046;34277;16594;17683;43.6572;42.0592;45.1568
563153;67;34;33;48.5000;45.6765;51.4091
553239;792;398;394;42.3889;41.9724;42.8096
551601;281;134;147;39.7705;37.4925;41.8469
599123;391;198;193;37.1394;37.0253;37.2565
553255;254;128;126;45.2126;44.0313;46.4127
553263;282;152;130;38.4149;38.4934;38.3231
553271;6361;3127;3234;43.6989;42.4124;44.9428
553280;134;71;63;48.7761;45.8239;52.1032
553298;324;160;164;43.9630;43.2188;44.6890
563447;96;51;45;43.5104;44.7157;42.1444
553310;165;92;73;46.3727;43.6196;49.8425
553328;153;82;71;50.7745;48.5366;53.3592
563927;35;16;19;53.5857;53.9375;53.2895
599000;63;33;30;44.2302;43.9242;44.5667
553361;250;115;135;44.8200;43.3870;46.0407
599034;100;53;47;41.6100;40.7642;42.5638
560430;166;78;88;43.4578;44.1538;42.8409
599271;277;133;144;42.3195;41.8759;42.7292
553409;403;201;202;42.8251;43.4005;42.2525
553417;1001;512;489;38.3681;38.0449;38.7065
563897;250;134;116;42.1520;41.9403;42.3966
553433;325;166;159;41.6877;41.7771;41.5943
553441;1751;896;855;43.2304;42.6596;43.8287
553450;1546;801;745;39.2180;38.0056;40.5215
566136;406;216;190;43.2266;40.6667;46.1368
553506;120;53;67;37.6083;37.8208;37.4403
566080;98;54;44;33.8776;31.9074;36.2955
553514;251;124;127;43.8705;41.6290;46.0591
566098;161;82;79;52.5186;46.8659;58.3861
553549;969;507;462;38.6115;38.2101;39.0519
553557;393;192;201;45.4160;44.4427;46.3458
553425;11094;5321;5773;43.5862;41.9497;45.0945
553573;196;100;96;39.3367;38.9500;39.7396
553581;428;216;212;41.3505;39.7176;43.0142
553620;283;140;143;42.2385;43.8929;40.6189
566641;187;91;96;45.9813;43.0824;48.7292
553654;5173;2576;2597;41.5709;40.6281;42.5062
566276;63;28;35;48.9603;50.4643;47.7571
553662;255;124;131;40.4882;40.1935;40.7672
553671;5034;2521;2513;42.7890;41.7007;43.8808
553689;1318;692;626;41.7982;42.0072;41.5671
566179;181;96;85;39.8260;38.8438;40.9353
566331;37;20;17;41.5811;40.4500;42.9118
553727;114;55;59;46.9561;42.6455;50.9746
553735;761;388;373;43.6393;42.4407;44.8861
553743;418;201;217;42.6388;42.2015;43.0438
553751;385;207;178;40.4039;39.5435;41.4045
566144;206;104;102;40.0485;37.3173;42.8333
553778;28;15;13;48.6429;43.7667;54.2692
553786;5183;2510;2673;43.1514;41.8068;44.4140
553794;1350;666;684;42.2496;41.1862;43.2851
553816;969;494;475;43.6992;42.4372;45.0116
553824;1124;540;584;43.4190;42.8130;43.9795
553832;147;82;65;43.8537;42.7195;45.2846
553841;411;217;194;39.7774;38.5553;41.1443
553859;117;54;63;39.0983;38.9444;39.2302
553867;130;66;64;46.4615;46.5303;46.3906
553891;399;211;188;40.0288;39.0924;41.0798
553913;1193;601;592;39.1136;38.7512;39.4814
553921;112;54;58;37.0000;35.6852;38.2241
553930;116;65;51;48.9138;49.3000;48.4216
553948;596;292;304;42.5805;41.3082;43.8026
553956;293;156;137;38.7116;37.1795;40.4562
566292;214;115;99;42.2617;41.9261;42.6515
599174;62;31;31;43.5000;43.6935;43.3065
553981;1133;577;556;43.1381;42.6352;43.6601
553999;260;131;129;42.5538;43.6145;41.4767
554006;258;134;124;39.8488;41.5224;38.0403
599166;142;74;68;41.5704;41.6622;41.4706
554022;150;78;72;40.8000;41.7564;39.7639
554031;187;96;91;40.6979;38.2396;43.2912
599131;145;77;68;43.7759;44.7208;42.7059
554057;222;110;112;40.7703;42.1455;39.4196
554073;631;319;312;42.0959;40.6129;43.6122
566209;114;65;49;42.3070;43.1154;41.2347
599182;198;103;95;36.6566;36.7816;36.5211
554081;208;108;100;44.0577;41.8333;46.4600
554090;232;122;110;43.9224;41.8279;46.2455
566373;75;38;37;40.7000;38.6316;42.8243
554111;1581;764;817;43.4222;42.8874;43.9223
554120;600;317;283;42.4250;42.1877;42.6908
566365;244;135;109;43.9877;44.0407;43.9220
554138;1127;580;547;44.8354;42.7586;47.0375
554154;357;177;180;42.2423;42.1497;42.3333
554189;177;93;84;40.2571;42.5968;37.6667
554201;255;131;124;31.8804;31.7443;32.0242
554251;206;109;97;40.9320;39.3532;42.7062
554260;381;195;186;46.3766;46.6333;46.1075
554278;480;243;237;40.9542;40.7016;41.2131
554294;3319;1674;1645;43.3289;41.6947;44.9918
554316;220;118;102;43.0500;42.2373;43.9902
566101;88;44;44;43.1364;42.5682;43.7045
554341;429;212;217;43.1760;43.0094;43.3387
554359;535;264;271;45.1935;44.8333;45.5443
566161;131;69;62;39.9275;39.0652;40.8871
554383;429;214;215;41.1154;41.0467;41.1837
554391;110;61;49;41.5727;38.4180;45.5000
554405;127;60;67;43.7677;43.7500;43.7836
554413;249;127;122;40.2309;43.5472;36.7787
554421;178;83;95;41.6236;42.1988;41.1211
566250;125;66;59;38.4040;35.2576;41.9237
566071;102;58;44;39.8824;35.9138;45.1136
554448;42;22;20;57.4524;55.8636;59.2000
554456;819;423;396;41.5757;41.0366;42.1515
554464;1042;544;498;41.4962;39.9522;43.1827
554472;157;76;81;41.4427;41.2632;41.6111
541842;224;128;96;41.5402;42.4297;40.3542
555797;815;421;394;42.7748;41.2696;44.3832
555801;918;454;464;42.4150;41.1630;43.6401
578088;136;69;67;43.2647;45.6304;40.8284
555835;765;373;392;39.8582;38.1944;41.4413
541923;182;97;85;44.1648;42.7474;45.7824
555894;298;155;143;45.9128;44.3194;47.6399
530085;63;30;33;43.8333;48.4000;39.6818
555941;506;284;222;44.2964;43.6620;45.1081
553531;358;176;182;42.5642;41.9148;43.1923
542172;233;121;112;43.8691;41.9132;45.9821
542024;219;106;113;43.3493;43.4906;43.2168
578495;188;93;95;47.7500;48.7258;46.7947
556041;706;365;341;42.4178;41.5904;43.3035
556068;483;252;231;40.6511;40.0476;41.3095
556076;869;465;404;42.5667;42.6505;42.4703
530123;105;52;53;44.7381;44.5000;44.9717
556106;931;470;461;41.2003;41.1021;41.3004
578517;54;33;21;51.7778;49.2576;55.7381
566683;163;89;74;42.4141;41.0843;44.0135
578525;111;52;59;41.6712;44.0769;39.5508
578240;122;72;50;43.9508;44.6944;42.8800
556181;959;502;457;46.6460;44.1673;49.3687
541796;162;84;78;45.7160;43.8214;47.7564
556203;483;248;235;44.9720;43.5524;46.4702
542083;97;55;42;49.1598;48.6818;49.7857
556254;5240;2562;2678;44.8882;43.2596;46.4462
542091;60;25;35;42.1167;43.8200;40.9000
556301;1394;710;684;42.3494;41.1958;43.5468
556319;426;220;206;43.1878;43.2773;43.0922
556335;702;385;317;44.5228;42.9182;46.4716
556343;136;69;67;46.7794;44.4565;49.1716
556378;771;378;393;43.4429;42.0423;44.7901
556386;611;313;298;39.3363;39.0687;39.6174
556394;2302;1186;1116;40.1612;39.3322;41.0421
541869;72;37;35;43.0833;42.7432;43.4429
541753;235;117;118;42.4362;42.0385;42.8305
556432;1427;701;726;45.7320;42.5899;48.7658
541826;104;47;57;42.5962;43.3936;41.9386
555771;22257;10683;11574;44.4880;42.8703;45.9812
541851;110;63;47;41.0182;38.5794;44.2872
556467;1464;745;719;43.2329;42.5711;43.9186
578177;83;37;46;41.5120;43.9054;39.5870
556505;204;108;96;40.9853;37.9722;44.3750
541931;130;60;70;46.9923;45.3333;48.4143
578070;133;67;66;41.0489;41.9627;40.1212
556629;512;270;242;45.2500;45.2185;45.2851
578410;47;27;20;47.7979;45.2778;51.2000
556637;1147;579;568;43.1792;42.9180;43.4454
578461;64;34;30;44.5781;47.0000;41.8333
542059;55;32;23;45.2091;44.0313;46.8478
542148;78;43;35;38.3205;39.4535;36.9286
556718;1092;568;524;41.6886;41.0000;42.4351
556726;129;62;67;45.5388;41.2258;49.5299
556734;434;218;216;45.4539;43.7385;47.1852
541745;133;63;70;44.5301;46.4048;42.8429
556751;1175;598;577;45.9817;43.9565;48.0806
578223;76;32;44;40.4474;35.5000;44.0455
578533;218;116;102;48.4633;49.0259;47.8235
556815;330;163;167;48.4303;47.7086;49.1347
556831;4929;2441;2488;42.9954;41.4472;44.5145
541915;206;102;104;43.4951;42.6765;44.2981
541958;204;107;97;45.3235;43.7336;47.0773
578061;71;33;38;39.0352;37.8636;40.0526
556912;725;381;344;45.9607;44.3346;47.7616
556921;636;331;305;42.2563;41.6782;42.8836
556955;1663;846;817;44.1999;43.4232;45.0043
551686;148;76;72;42.0878;40.7632;43.4861
541788;289;152;137;44.2266;42.9605;45.6314
556084;154;83;71;40.8766;41.1506;40.5563
557005;803;395;408;41.1762;41.3025;41.0539
557013;494;248;246;44.6903;42.8831;46.5122
557021;247;130;117;43.3016;42.1923;44.5342
578436;104;54;50;47.2885;44.3889;50.4200
557099;384;193;191;46.1302;43.9870;48.2958
557111;224;109;115;46.5938;48.5459;44.7435
557129;333;173;160;44.6351;44.4422;44.8438
557137;1420;725;695;43.2831;42.9634;43.6165
557153;11032;5327;5705;44.4117;42.5854;46.1170
557161;324;155;169;45.1265;43.8677;46.2811
557200;1661;818;843;43.5295;42.2958;44.7266
553522;95;49;46;44.3632;40.9694;47.9783
541885;341;179;162;42.2478;41.6229;42.9383
578321;129;70;59;41.4457;40.0429;43.1102
557366;850;440;410;45.0588;43.7955;46.4146
557374;259;128;131;44.1371;42.9453;45.3015
557382;551;283;268;41.8049;40.4788;43.2052
557455;879;443;436;42.7503;42.2833;43.2248
566055;324;167;157;42.5340;40.4760;44.7229
557463;423;220;203;45.0910;45.6136;44.5246
578312;104;60;44;47.2308;43.0333;52.9545
557528;1643;835;808;42.5986;41.5874;43.6436
557536;601;294;307;44.6498;45.1020;44.2166
557544;654;313;341;46.1346;45.2700;46.9282
558851;1861;931;930;41.7783;41.0048;42.5527
558966;1917;960;957;43.3779;42.3802;44.3788
557846;751;383;368;39.7636;38.5000;41.0788
559130;1043;522;521;39.9813;39.2682;40.6958
540561;734;359;375;39.5967;38.9067;40.2573
578606;202;102;100;41.0297;41.5490;40.5000
558001;1360;659;701;41.8765;42.5182;41.2732
540641;271;132;139;38.4336;38.9773;37.9173
553590;243;122;121;41.5700;40.8197;42.3264
558141;1461;713;748;42.8196;41.8590;43.7353
554791;174842;85453;89389;43.1499;41.6952;44.5406
558371;5151;2512;2639;42.5311;41.4148;43.5936
558427;2815;1405;1410;42.2964;40.7363;43.8511
539741;592;305;287;40.0253;39.6443;40.4303
558460;1037;540;497;39.4875;39.3685;39.6167
557587;4128;2051;2077;43.3641;41.4005;45.3031
540463;55;23;32;46.3727;49.0652;44.4375
566705;92;44;48;47.8696;45.5000;50.0417
542156;230;115;115;40.6565;41.0913;40.2217
546372;237;122;115;42.6181;41.0820;44.2478
557641;569;281;288;41.9587;40.6495;43.2361
557650;667;345;322;44.9633;44.7087;45.2360
578568;131;74;57;43.1336;42.2027;44.3421
557668;897;486;411;43.5992;42.7078;44.6533
557676;6145;3047;3098;41.2273;39.8489;42.5830
539945;302;151;151;42.2583;42.6060;41.9106
557684;1003;512;491;40.6595;39.8320;41.5224
540251;139;77;62;42.5360;39.8247;45.9032
540668;260;127;133;42.5808;41.9646;43.1692
539821;466;250;216;43.0408;42.1960;44.0185
557722;427;213;214;41.4063;40.8380;41.9720
557731;556;280;276;42.5576;42.1179;43.0036
557749;225;122;103;45.5311;43.1721;48.3252
557773;231;110;121;44.4870;45.1091;43.9215
557781;2417;1232;1185;41.7710;40.4351;43.1599
540307;206;137;69;49.8592;51.5438;46.5145
557803;590;286;304;41.6068;40.6503;42.5066
557838;2914;1482;1432;41.4708;40.4676;42.5091
578541;214;117;97;49.4579;49.0641;49.9330
557862;1288;672;616;43.5148;42.1890;44.9610
557871;303;163;140;46.0611;45.1258;47.1500
557897;227;116;111;43.9361;43.9483;43.9234
540633;315;153;162;40.2714;38.4020;42.0370
540200;87;48;39;48.1782;47.0625;49.5513
557943;112;49;63;43.2768;41.3980;44.7381
557951;670;352;318;45.7164;43.8494;47.7830
540064;125;64;61;43.7960;44.0625;43.5164
540617;166;82;84;45.5361;47.0488;44.0595
558010;98;49;49;43.0408;42.3980;43.6837
558028;667;331;336;44.2121;42.4698;45.9286
539716;224;113;111;42.6071;41.2611;43.9775
558044;1179;596;583;41.6272;40.3171;42.9666
558052;380;212;168;46.9526;45.4057;48.9048
530140;208;106;102;44.6779;40.8302;48.6765
546399;121;66;55;44.1529;42.7121;45.8818
558061;700;365;335;44.7114;42.8205;46.7716
558079;63;30;33;44.3730;40.9667;47.4697
540340;363;182;181;42.1860;41.4945;42.8812
558095;171;90;81;44.9094;43.0556;46.9691
558109;3735;1878;1857;42.4866;41.8371;43.1435
558117;194;100;94;39.9742;39.2600;40.7340
558125;866;485;381;46.1328;47.0237;44.9987
542296;214;104;110;43.2664;43.6538;42.9000
540102;103;51;52;48.7136;49.0098;48.4231
540269;287;136;151;40.9808;40.9926;40.9702
558176;341;188;153;45.0425;42.9415;47.6242
539783;329;173;156;43.1930;40.7890;45.8590
558184;360;174;186;45.8472;46.0862;45.6237
540293;153;80;73;45.8333;45.7000;45.9795
553565;44;28;16;51.9091;53.0357;49.9375
558231;250;158;92;45.9440;46.4810;45.0217
540412;247;111;136;42.4271;43.8423;41.2721
530131;234;116;118;45.6538;44.1293;47.1525
558249;7131;3541;3590;43.5189;42.4687;44.5549
558257;1112;571;541;41.4020;40.2356;42.6331
558265;203;100;103;43.4458;41.2000;45.6262
540421;102;60;42;41.7353;38.0667;46.9762
558290;257;136;121;45.6712;41.8382;49.9793
558303;931;480;451;42.3496;42.0250;42.6951
558311;309;144;165;41.2282;40.6806;41.7061
540692;106;54;52;46.5000;50.0000;42.8654
539937;214;106;108;45.8785;47.8491;43.9444
558346;608;303;305;43.9934;42.7244;45.2541
558362;2856;1456;1400;41.9153;40.9162;42.9543
540676;169;88;81;46.6716;48.9091;44.2407
558389;3617;1809;1808;44.0192;42.3071;45.7323
540056;145;70;75;39.9897;42.3714;37.7667
558401;379;199;180;44.0541;43.7613;44.3778
558435;2161;1077;1084;39.0997;37.9661;40.2260
578614;100;52;48;44.5300;40.6731;48.7083
578592;125;80;45;40.0440;39.5875;40.8556
539929;46;23;23;46.7826;49.6739;43.8913
540528;149;74;75;43.5872;42.3243;44.8333
558486;694;348;346;42.6095;42.5690;42.6503
558494;367;182;185;40.3529;41.0165;39.7000
566691;71;29;42;47.4577;47.7414;47.2619
540706;91;49;42;43.7308;40.9694;46.9524
558559;343;180;163;41.2872;39.4722;43.2914
558567;522;282;240;42.6954;40.6099;45.1458
558583;630;312;318;41.0571;41.4295;40.6918
558591;285;147;138;45.8404;44.8673;46.8768
530182;477;241;236;39.3868;38.4461;40.3475
558605;462;234;228;44.4957;43.4231;45.5965
558630;859;418;441;47.5861;45.4713;49.5907
540137;42;24;18;53.5000;49.0417;59.4444
566756;720;384;336;38.8361;37.4766;40.3899
558656;669;343;326;43.2444;42.3484;44.1871
530239;79;42;37;44.7658;45.9762;43.3919
558672;898;441;457;40.6626;40.6723;40.6532
566764;64;34;30;42.9688;39.7647;46.6000
566471;128;64;64;46.3672;47.3438;45.3906
566489;69;32;37;49.7899;47.0938;52.1216
558699;171;89;82;41.4532;36.6685;46.6463
558711;273;143;130;40.7234;39.8706;41.6615
566632;88;40;48;39.7500;38.5750;40.7292
530328;207;101;106;43.3841;44.8762;41.9623
558745;580;288;292;42.5172;41.8750;43.1507
558770;422;218;204;43.6469;43.4541;43.8529
558788;295;156;139;43.7305;40.1538;47.7446
558796;460;229;231;44.1848;43.4214;44.9416
558800;64;36;28;46.7656;48.1111;45.0357
578665;148;76;72;39.7770;39.2632;40.3194
558834;804;386;418;40.4602;39.9845;40.8995
558869;1806;903;903;42.2320;40.9430;43.5210
566390;74;36;38;43.1216;44.1667;42.1316
530221;122;59;63;43.5000;45.6695;41.4683
566730;55;24;31;51.9727;58.3750;47.0161
558877;580;320;260;42.7569;40.6000;45.4115
558885;4180;2076;2104;42.9529;40.9605;44.9187
558915;1240;628;612;42.8202;41.7500;43.9183
558931;249;128;121;43.1265;41.6094;44.7314
558940;1221;612;609;41.5090;40.4820;42.5411
558974;222;122;100;44.3243;43.7131;45.0700
558982;140;72;68;44.6214;44.1250;45.1471
558991;150;74;76;39.1933;38.0946;40.2632
559008;3049;1493;1556;42.8099;41.6976;43.8772
538183;116;53;63;41.5948;40.8774;42.1984
578771;120;63;57;42.9000;42.8968;42.9035
559024;141;73;68;45.6418;44.7603;46.5882
559032;133;71;62;44.9586;45.2183;44.6613
559041;586;303;283;45.3123;44.2459;46.4541
559059;1092;552;540;42.3434;40.7862;43.9352
559067;1439;728;711;43.4972;41.5824;45.4578
559075;3478;1693;1785;43.2119;42.0021;44.3594
559083;361;185;176;46.4335;46.8351;46.0114
559091;249;134;115;42.8092;42.0896;43.6478
559105;237;121;116;40.5295;40.6570;40.3966
559121;158;82;76;37.5823;37.2683;37.9211
559148;847;432;415;41.3678;40.0718;42.7169
559164;2783;1382;1401;40.6135;39.8343;41.3822
559172;739;365;374;40.5149;41.7658;39.2941
566420;203;105;98;46.4261;45.7095;47.1939
566462;116;64;52;41.2672;43.3594;38.6923
566446;262;136;126;42.0076;41.3382;42.7302
559202;1151;596;555;45.3028;44.9765;45.6532
559211;2172;1064;1108;40.8628;40.0818;41.6128
559237;549;280;269;42.5200;41.7357;43.3364
559245;332;158;174;41.8404;42.0063;41.6897
566543;203;105;98;36.4261;37.4048;35.3776
559253;121;61;60;42.1694;41.9426;42.4000
559261;634;318;316;45.8328;45.3396;46.3291
559270;516;267;249;42.2171;42.1592;42.2791
559288;288;156;132;41.0660;39.4423;42.9848
559300;6996;3453;3543;42.3275;40.7986;43.8175
559318;556;279;277;42.0144;42.2599;41.7671
559326;208;106;102;41.3846;40.3396;42.4706
566781;70;36;34;44.1143;44.1944;44.0294
559334;763;379;384;42.3820;42.2520;42.5104
530336;262;137;125;44.5458;43.5073;45.6840
559351;2716;1359;1357;43.5029;42.1924;44.8154
559369;281;136;145;39.1868;38.3676;39.9552
559377;430;217;213;45.8628;44.4078;47.3451
530247;137;69;68;43.2372;44.7029;41.7500
559393;459;235;224;43.5980;42.3000;44.9598
567086;319;163;156;40.7947;39.2178;42.4423
559423;304;142;162;38.8520;41.4718;36.5556
559431;570;277;293;40.9386;42.5000;39.4625
530271;120;62;58;34.4000;33.9516;34.8793
566748;55;28;27;50.9545;49.1429;52.8333
553603;34;17;17;51.1176;48.5000;53.7353
578797;113;59;54;44.4469;44.4153;44.4815
578983;248;127;121;42.2621;41.0354;43.5496
559482;111;56;55;43.1126;45.1786;41.0091
559491;3265;1636;1629;40.4351;39.2922;41.5829
559504;935;473;462;42.2626;41.3774;43.1688
559521;5082;2553;2529;42.9359;41.8169;44.0654
546411;374;199;175;39.1524;37.5503;40.9743
566594;105;62;43;44.7571;41.8226;48.9884
559555;490;258;232;43.8898;43.4496;44.3793
559563;586;299;287;44.1365;43.2692;45.0401
559571;464;230;234;42.8082;43.1565;42.4658
559580;4302;2103;2199;38.4663;37.4729;39.4163
578924;65;33;32;50.7923;49.8636;51.7500
559601;1176;575;601;35.9813;35.6913;36.2587
566497;53;27;26;42.1604;41.5370;42.8077
559628;1577;789;788;38.3567;38.3175;38.3959
566969;450;233;217;43.8889;41.4442;46.5138
530280;222;112;110;44.0856;41.9821;46.2273
578827;136;73;63;42.5441;43.0753;41.9286
559661;2609;1361;1248;40.7882;40.0893;41.5505
559679;3341;1629;1712;42.0618;41.3287;42.7593
559695;1309;657;652;44.5138;42.2884;46.7561
559709;433;233;200;42.6594;41.8262;43.6300
541095;144;70;74;40.3611;41.6143;39.1757
559725;2286;1135;1151;43.4243;41.9960;44.8328
559733;371;192;179;42.5296;40.2031;45.0251
559741;68;36;32;45.3088;36.1944;55.5625
559750;608;315;293;42.2862;41.8968;42.7048
559768;137;74;63;39.0766;37.3108;41.1508
540927;18;9;9;50.3889;40.2778;60.5000
559776;1321;670;651;41.9716;40.7254;43.2542
530379;127;66;61;46.4055;44.4545;48.5164
559792;687;350;337;40.5378;38.7857;42.3576
559806;322;155;167;45.8261;46.0290;45.6377
559814;1456;733;723;44.3867;43.8479;44.9329
559822;2850;1453;1397;43.2396;41.8008;44.7362
541001;36;19;17;46.6944;49.0789;44.0294
559849;233;114;119;45.5815;46.4561;44.7437
559857;734;379;355;41.9877;40.1596;43.9394
540803;49;20;29;48.6224;53.2500;45.4310
541141;63;39;24;48.2302;48.8590;47.2083
579017;97;48;49;42.9124;43.7083;42.1327
566811;64;33;31;37.5000;38.2879;36.6613
541150;848;429;419;40.9316;39.7238;42.1683
559903;681;359;322;41.5411;40.5111;42.6894
530361;52;26;26;37.8654;34.8846;40.8462
559911;467;227;240;44.6692;44.2753;45.0417
559920;156;86;70;49.3718;49.3256;49.4286
579033;192;101;91;40.0833;39.1436;41.1264
567001;313;160;153;41.6725;41.8188;41.5196
559946;57;31;26;44.6754;42.3065;47.5000
559954;272;144;128;55.7353;53.7222;58.0000
559962;189;92;97;39.6217;38.3478;40.8299
553611;534;274;260;41.9457;39.0219;45.0269
579009;250;123;127;44.5560;41.3211;47.6890
579084;85;46;39;44.7824;43.0870;46.7821
559997;2274;1131;1143;44.5616;41.8210;47.2734
560006;296;150;146;42.5304;41.3467;43.7466
560014;1544;785;759;42.8744;42.0694;43.7069
566837;181;94;87;40.8978;41.8936;39.8218
541192;177;84;93;41.7147;41.8810;41.5645
560057;1438;733;705;40.5890;39.9025;41.3028
566993;107;46;61;46.5561;48.5870;45.0246
566861;129;66;63;43.8876;45.0000;42.7222
560081;250;129;121;44.6320;42.6628;46.7314
579131;420;213;207;41.8905;41.7958;41.9879
560111;199;108;91;46.4246;45.0926;48.0055
560120;1822;914;908;42.6625;41.0044;44.3315
566942;240;125;115;41.8042;42.0120;41.5783
559717;14383;7060;7323;42.8511;41.3667;44.2822
560146;67;40;27;50.0373;52.8500;45.8704
546488;140;68;72;42.6143;38.7500;46.2639
566845;211;112;99;43.6469;42.5982;44.8333
506664;256;136;120;42.9492;41.9044;44.1333
540722;291;134;157;38.7955;39.0672;38.5637
560162;2565;1287;1278;42.0688;40.8023;43.3443
541176;435;222;213;43.4080;42.7297;44.1150
579343;57;35;22;46.0789;49.1286;41.2273
560189;274;136;138;43.7847;42.6838;44.8696
566802;185;88;97;38.7649;39.1023;38.4588
546526;310;149;161;46.3065;44.8087;47.6925
579246;103;46;57;43.0243;40.5000;45.0614
546534;222;112;110;44.9595;43.8571;46.0818
546551;243;130;113;45.5617;42.8846;48.6416
560227;256;120;136;42.0352;40.7667;43.1544
560235;282;156;126;40.4787;38.6410;42.7540
579289;59;27;32;35.1271;32.2778;37.5313
560251;1182;591;591;41.4535;39.8029;43.1041
566799;269;137;132;43.9461;44.6387;43.2273
560260;2508;1236;1272;42.8293;41.9134;43.7193
541061;207;66;141;43.0121;43.7424;42.6702
560723;210;94;116;41.6190;42.6702;40.7672
560740;938;469;469;41.5309;40.0032;43.0586
560758;4486;2282;2204;40.9048;39.8309;42.0168
541605;248;122;126;40.5161;41.2705;39.7857
541401;140;73;67;38.0786;37.6507;38.5448
560782;276;132;144;39.3659;38.2500;40.3889
579459;323;163;160;44.0820;43.1810;45.0000
560804;346;182;164;41.4595;41.5275;41.3841
560812;1169;593;576;42.7104;41.7243;43.7257
560839;397;211;186;39.5277;38.5427;40.6452
560855;336;178;158;43.3482;42.5955;44.1962
560863;940;471;469;40.1223;40.0754;40.1695
541290;256;135;121;42.4922;42.5741;42.4008
560898;428;231;197;39.4860;40.0887;38.7792
560901;1880;987;893;40.9989;40.2670;41.8080
560910;799;394;405;41.6414;42.9442;40.3741
560928;1640;844;796;40.5799;39.5344;41.6884
541559;220;109;111;35.3500;35.1330;35.5631
541494;261;130;131;40.5690;38.4462;42.6756
560952;920;448;472;47.0685;46.2411;47.8538
503916;602;315;287;36.8887;36.5222;37.2909
560979;217;116;101;42.3387;41.2241;43.6188
561002;466;235;231;40.7768;40.5043;41.0541
561011;393;201;192;41.3524;39.7836;42.9948
541702;460;226;234;37.3043;37.6770;36.9444
541532;271;148;123;38.2380;37.6419;38.9553
541443;156;82;74;41.7756;41.9146;41.6216
566888;59;30;29;46.8729;45.8000;47.9828
541681;168;88;80;34.9940;34.5795;35.4500
561134;5396;2669;2727;42.3808;41.1718;43.5642
541486;149;84;65;42.9094;43.8095;41.7462
561151;1608;837;771;37.9683;37.7162;38.2419
561169;798;390;408;40.4561;40.1282;40.7696
579467;119;60;59;42.0546;37.8833;46.2966
561185;1263;653;610;37.5008;36.8476;38.2000
561193;248;132;116;46.1048;46.9470;45.1466
561207;1204;600;604;39.9743;39.1417;40.8013
561215;7738;3885;3853;43.1478;41.8086;44.4982
561223;543;286;257;38.6105;37.3601;40.0019
561231;231;127;104;42.9026;43.0827;42.6827
561258;453;212;241;39.4492;40.2736;38.7241
557081;317;177;140;44.2161;45.2853;42.8643
560715;13038;6459;6579;43.2097;41.7421;44.6505
541621;466;248;218;41.2039;39.8508;42.7431
561291;272;152;120;41.2868;39.6974;43.3000
561304;378;195;183;43.2566;42.3308;44.2432
541435;135;73;62;36.6556;35.3767;38.1613
579491;181;96;85;42.2735;43.1250;41.3118
541362;251;139;112;44.4203;41.1547;48.4732
541664;393;189;204;38.4109;38.6270;38.2108
541460;150;73;77;36.3933;37.9932;34.8766
554499;13182;6584;6598;41.4942;39.8665;43.1184
554502;1235;631;604;40.9405;39.1577;42.8030
554511;1013;502;511;41.0518;40.4821;41.6115
554529;5461;2639;2822;43.9474;42.3537;45.4376
554545;1566;798;768;42.4598;41.7306;43.2174
554553;2147;1080;1067;43.0002;42.3667;43.6415
554481;31977;15742;16235;42.4172;40.8918;43.8962
538795;612;324;288;41.0163;40.6883;41.3854
554596;276;131;145;43.5833;45.0038;42.3000
554600;1439;705;734;44.1949;41.6745;46.6158
554618;800;407;393;42.2550;41.8857;42.6374
554626;746;383;363;41.6501;42.4608;40.7948
554634;2144;1071;1073;44.2761;43.9444;44.6072
554642;12795;6067;6728;45.9205;43.6889;47.9328
554651;331;174;157;38.1616;36.7644;39.7102
538906;289;158;131;41.1955;42.7785;39.2863
554677;407;169;238;43.6130;41.7722;44.9202
554693;343;163;180;41.0598;39.4509;42.5167
554707;500;249;251;41.9400;41.5683;42.3088
539554;258;129;129;41.7442;42.8023;40.6860
538922;254;125;129;42.5394;43.4840;41.6240
539473;124;64;60;44.0242;44.2500;43.7833
554740;1940;973;967;41.9273;41.5781;42.2787
538817;188;102;86;41.4628;40.6373;42.4419
538868;302;160;142;38.8775;39.1938;38.5211
577979;166;83;83;39.0181;39.6325;38.4036
539538;106;61;45;43.6792;43.5000;43.9222
554812;1988;961;1027;42.7394;40.7081;44.6402
539112;517;270;247;40.6238;40.0519;41.2490
555631;2954;1487;1467;41.1273;39.8302;42.4421
554855;385;200;185;41.8195;41.0750;42.6243
539023;399;202;197;43.4373;43.1287;43.7538
554880;967;486;481;40.9436;40.0761;41.8202
539619;149;79;70;43.8826;44.1203;43.6143
539481;473;247;226;43.8911;41.6700;46.3186
539279;2350;1158;1192;42.8902;41.4465;44.2928
578002;164;88;76;38.7256;39.3750;37.9737
539376;116;58;58;44.8017;42.7586;46.8448
539074;233;126;107;42.9292;45.4286;39.9860
539431;338;177;161;44.1598;44.1949;44.1211
554979;939;487;452;42.7492;43.0811;42.3916
538001;370;171;199;41.4459;42.4474;40.5854
554995;942;492;450;44.1507;43.1402;45.2556
555029;1983;998;985;41.1178;40.7585;41.4817
506486;250;128;122;40.7960;39.3906;42.2705
555045;630;327;303;40.3127;39.4908;41.1997
500101;221;124;97;37.7715;38.8065;36.4485
537870;546;265;281;43.8791;42.8774;44.8238
538019;307;164;143;43.9821;46.4756;41.1224
506621;177;82;95;37.1610;37.6220;36.7632
537918;1989;991;998;42.5337;41.7583;43.3036
538116;385;210;175;44.9260;45.1762;44.6257
500127;162;95;67;38.8025;38.4053;39.3657
538159;631;332;299;40.4350;40.2139;40.6806
555169;395;208;187;42.4494;41.3077;43.7193
551651;297;149;148;40.7593;41.2181;40.2973
555177;0;0;0;0.0000;0.0000;0.0000
555185;2031;1030;1001;41.3252;40.0728;42.6139
578011;115;69;46;38.8739;38.1377;39.9783
555207;591;311;280;42.5034;41.2846;43.8571
555215;2470;1194;1276;43.0466;41.1147;44.8542
537926;1086;534;552;38.6906;38.7004;38.6812
554961;48479;23257;25222;45.4280;43.7106;47.0117
555258;790;397;393;41.4797;40.8174;42.1489
555304;400;204;196;43.0575;42.6471;43.4847
578045;330;165;165;40.9818;41.1788;40.7848
555347;789;412;377;43.0425;42.1335;44.0358
555363;946;466;480;42.3774;42.6030;42.1583
537934;328;169;159;42.1128;41.6479;42.6069
555380;7806;3881;3925;43.3000;41.7739;44.8090
555398;4132;2001;2131;43.5145;41.6899;45.2278
506494;343;189;154;47.2522;47.7381;46.6558
555428;16658;8162;8496;43.7632;42.3194;45.1503
537969;950;469;481;40.2968;40.4701;40.1279
555444;436;233;203;44.3119;42.4056;46.5000
555452;595;301;294;46.5151;44.5100;48.5680
556947;552;264;288;42.0978;40.6970;43.3819
555479;436;233;203;38.0894;37.2039;39.1059
555525;584;309;275;43.1164;42.3188;44.0127
555533;1273;661;612;41.9713;40.3744;43.6961
538027;217;117;100;38.3111;36.4231;40.5200
555550;629;327;302;41.2107;42.0413;40.3113
555584;600;300;300;43.7383;43.7367;43.7400
555592;581;287;294;39.5809;39.4094;39.7483
555614;666;344;322;40.2117;39.5610;40.9068
555622;537;279;258;43.5633;43.8297;43.2752
537845;123;65;58;43.2724;45.0077;41.3276
555657;3669;1834;1835;42.9336;42.1178;43.7490
555681;585;287;298;39.9650;38.6777;41.2047
555690;368;196;172;43.4130;41.2296;45.9012
555703;543;288;255;42.6381;42.7847;42.4725
555711;470;252;218;41.0064;40.3294;41.7890
555738;650;353;297;42.4523;42.8059;42.0320
566675;194;90;104;38.7010;41.3333;36.4231
578029;349;150;199;44.5745;42.3867;46.2236
555762;2293;1133;1160;44.0430;42.3111;45.7345
560294;2699;1309;1390;42.8983;41.0699;44.6201
560308;403;223;180;45.1576;45.1413;45.1778
560316;1550;786;764;41.1813;40.3779;42.0079
560324;911;460;451;41.3672;40.8609;41.8836
560332;277;152;125;40.2004;39.2039;41.4120
560341;361;188;173;40.0180;38.6170;41.5405
538591;1314;678;636;39.9696;38.9897;41.0142
560359;4876;2417;2459;42.6501;41.5964;43.6858
560367;5403;2762;2641;42.0454;40.5047;43.6568
560375;279;139;140;44.8118;43.3849;46.2286
560383;13300;6524;6776;42.5526;41.1810;43.8731
560413;504;276;228;45.0833;45.4529;44.6360
511587;383;189;194;41.8446;39.4841;44.1443
560421;442;225;217;41.4525;41.5889;41.3111
560456;967;500;467;41.0181;40.4120;41.6670
560464;789;423;366;40.2655;38.9586;41.7760
560472;6767;3396;3371;43.6370;42.5733;44.7085
538337;715;369;346;41.6133;40.3618;42.9480
560499;4799;2354;2445;43.8326;42.5212;45.0951
560502;535;265;270;43.2383;41.9566;44.4963
560537;3075;1546;1529;40.8180;39.7406;41.9075
560545;1345;678;667;40.0911;39.0560;41.1432
560561;194;110;84;38.0412;37.3000;39.0119
560570;2604;1335;1269;40.3610;40.1352;40.5985
560588;1657;815;842;42.0371;40.6313;43.3979
560596;73;39;34;45.9658;44.4231;47.7353
560600;3006;1491;1515;41.2395;39.6516;42.8023
560618;312;172;140;41.7179;41.6395;41.8143
560286;23033;11218;11815;42.9007;41.5034;44.2275
560642;836;439;397;43.3804;42.8212;43.9987
560651;471;251;220;44.4660;43.3924;45.6909
538434;1689;874;815;41.7913;40.9016;42.7454
538396;316;161;155;42.6646;42.3012;43.0419
560677;303;165;138;45.2690;45.6273;44.8406
538663;180;93;87;41.2444;40.9301;41.5805
579360;263;134;129;40.4316;39.8806;41.0039
560685;1196;585;611;36.4281;35.7769;37.0516
560707;385;204;181;33.6403;34.7304;32.4116
562343;407;208;199;42.5983;42.5048;42.6960
562351;3682;1858;1824;42.7385;40.9499;44.5603
544647;337;175;162;37.7908;38.3171;37.2222
562394;5235;2617;2618;43.5138;42.2287;44.7983
562335;48594;23646;24948;42.8470;41.2210;44.3881
562408;652;346;306;42.1442;41.1792;43.2353
545783;435;244;191;41.1460;41.0082;41.3220
545856;600;308;292;42.5167;41.2792;43.8219
562432;1190;603;587;41.9227;41.6708;42.1814
562441;1738;861;877;40.5006;39.6905;41.2959
530417;115;57;58;48.5783;51.2895;45.9138
545899;382;191;191;43.6152;41.9136;45.3168
562483;499;266;233;41.6944;41.8571;41.5086
545929;415;212;203;44.8181;42.8726;46.8498
562505;826;416;410;41.7131;41.7188;41.7073
562513;291;163;128;41.6821;40.6043;43.0547
562521;802;420;382;40.3716;39.9595;40.8246
562530;1357;699;658;41.1102;39.5143;42.8055
544680;357;166;191;49.0154;47.9217;49.9660
530395;208;104;104;40.2692;42.3077;38.2308
562556;389;203;186;47.1093;46.9039;47.3333
562564;5162;2567;2595;42.1459;40.8097;43.4676
562572;667;342;325;42.5165;41.2427;43.8569
562581;3638;1813;1825;42.2402;40.5634;43.9060
546453;252;131;121;38.9405;37.3855;40.6240
562611;3471;1721;1750;42.6196;41.1694;44.0457
546330;254;122;132;40.8740;42.4344;39.4318
562645;493;270;223;47.7454;47.9000;47.5583
544701;220;114;106;43.4955;42.5614;44.5000
562661;579;283;296;43.3532;40.4364;46.1419
545708;278;154;124;43.0144;42.3571;43.8306
546496;942;484;458;41.5127;40.1426;42.9607
562700;439;225;214;43.3064;41.4067;45.3037
562718;922;463;459;40.5282;39.7181;41.3453
545678;694;352;342;40.6009;39.8352;41.3889
545791;208;108;100;40.2885;40.2037;40.3800
562751;2182;1113;1069;43.3442;42.1253;44.6132
562777;11036;5408;5628;42.2116;40.7465;43.6194
566900;558;294;264;41.8029;41.0374;42.6553
562793;672;351;321;42.5744;42.5256;42.6277
546348;259;129;130;43.2143;42.5155;43.9077
562823;1232;641;591;42.9537;42.5842;43.3545
545538;207;110;97;40.7126;41.1000;40.2732
562858;5653;2845;2808;41.1547;39.9429;42.3825
555193;524;275;249;40.4027;38.9727;41.9819
562874;390;215;175;43.3590;43.5233;43.1571
562882;15193;7410;7783;42.8860;41.1516;44.5374
562891;509;258;251;41.7613;40.5891;42.9661
562912;1979;999;980;42.0114;40.7613;43.2857
562921;1166;606;560;41.3859;40.5000;42.3446
562939;358;184;174;40.9441;39.0217;42.9770
562947;894;426;468;44.7282;43.9460;45.4402
562980;241;122;119;42.0892;43.6475;40.4916
562998;554;287;267;42.4458;43.2282;41.6049
563005;289;161;128;40.3962;40.2329;40.6016
563013;1400;701;699;40.1136;40.0663;40.1609
563021;619;303;316;41.9491;42.1403;41.7658
563048;186;93;93;38.9355;40.3817;37.4892
563056;811;394;417;42.0191;42.8249;41.2578
563064;323;173;150;38.7012;38.9104;38.4600
563072;535;274;261;36.6944;36.6569;36.7337
563081;637;345;292;42.3273;42.6072;41.9966
562971;48635;24012;24623;42.4617;41.0585;43.8300
563099;19241;9522;9719;40.1841;38.7069;41.6313
563102;18246;9109;9137;41.5958;39.8862;43.3002
563111;233;129;104;43.2983;43.3760;43.2019
563129;14526;7185;7341;41.9908;40.6841;43.2696
563137;992;510;482;43.7853;42.6157;45.0228
563315;150;99;51;49.6267;49.2677;50.3235
563161;423;242;181;39.4716;40.6033;37.9586
563188;242;115;127;44.4793;45.5870;43.4764
546518;121;74;47;42.2438;44.4865;38.7128
563200;925;479;446;40.2027;39.4854;40.9731
563218;576;299;277;43.5816;43.6171;43.5433
563226;139;74;65;43.8165;44.1892;43.3923
563242;436;232;204;44.5642;43.0776;46.2549
546160;240;119;121;42.0958;39.9370;44.2190
563269;380;210;170;42.0263;41.7857;42.3235
563277;679;342;337;41.0950;40.2339;41.9688
563285;1149;599;550;42.2433;40.6569;43.9709
546062;174;90;84;39.1437;39.5778;38.6786
563293;196;113;83;40.1429;39.0310;41.6566
546071;403;202;201;40.3759;39.9109;40.8433
563323;1181;621;560;41.2096;39.9718;42.5821
563331;389;205;184;34.7237;34.3049;35.1902
563340;1519;777;742;39.7614;38.3301;41.2601
563358;1017;506;511;38.3427;38.1759;38.5078
563382;1236;636;600;41.2880;40.8145;41.7900
563404;2866;1465;1401;43.7313;43.6147;43.8533
563412;321;160;161;42.2695;41.4938;43.0404
563439;584;293;291;41.9161;42.0529;41.7784
563463;316;167;149;39.9873;39.7515;40.2517
563471;157;89;68;39.9331;39.2416;40.8382
563480;191;92;99;40.5733;40.8152;40.3485
563498;393;269;124;44.5534;45.3030;42.9274
563501;1075;543;532;43.9735;43.8278;44.1222
564575;1269;622;647;41.3400;40.6640;41.9900
564591;2511;1203;1308;41.6091;40.7760;42.3754
564613;442;224;218;42.0860;41.7857;42.3945
564621;1365;675;690;39.6656;38.7370;40.5739
546755;88;47;41;44.0114;44.4787;43.4756
564648;442;234;208;38.2964;37.3205;39.3942
564656;2165;1097;1068;42.6908;41.9239;43.4785
546780;297;156;141;40.9916;40.4936;41.5426
564672;363;175;188;41.3898;41.8429;40.9681
546852;219;107;112;41.7831;41.5841;41.9732
564699;149;80;69;44.1309;41.6625;46.9928
542423;296;163;133;42.8547;41.5184;44.4925
564711;1464;721;743;40.1954;38.7275;41.6198
564729;397;205;192;42.5504;41.4024;43.7760
564737;120;59;61;43.1083;43.4322;42.7951
564745;551;288;263;42.1243;41.7083;42.5798
564753;433;191;242;42.4007;43.2330;41.7438
553646;278;155;123;41.7842;40.4484;43.4675
564770;277;136;141;41.4495;38.9044;43.9043
564818;441;243;198;37.5884;36.0309;39.5000
564834;292;160;132;44.7671;40.9625;49.3788
564842;268;142;126;44.3507;43.8451;44.9206
564851;923;437;486;43.5758;42.0675;44.9321
546763;103;48;55;43.5291;40.3958;46.2636
564877;1751;903;848;39.0780;38.5709;39.6179
564893;684;349;335;40.7749;39.5774;42.0224
564923;655;318;337;43.2053;41.6981;44.6276
564931;162;83;79;42.9383;42.0060;43.9177
564940;470;253;217;42.9191;43.5632;42.1682
564958;290;146;144;38.9621;37.2123;40.7361
564966;209;108;101;43.6818;42.6296;44.8069
546810;169;89;80;38.2929;38.2416;38.3500
505528;335;172;163;46.9836;44.3547;49.7577
546771;178;97;81;40.5000;39.1701;42.0926
565016;363;182;181;41.5413;41.1099;41.9751
565024;495;266;229;44.1000;41.4850;47.1376
565032;532;269;263;41.2481;40.6450;41.8650
565059;448;236;212;41.2098;39.2924;43.3443
565067;898;435;463;44.1414;41.6724;46.4611
565075;331;175;156;46.2462;44.8429;47.8205
565083;1445;745;700;43.5768;42.9295;44.2657
565091;277;141;136;44.0921;43.9043;44.2868
565105;134;73;61;48.8507;45.6918;52.6311
565113;435;264;171;42.2609;43.2424;40.7456
565121;1532;805;727;42.3779;41.3224;43.5468
565148;557;275;282;40.7460;40.5218;40.9645
565156;570;292;278;42.2930;41.4726;43.1547
565164;3506;1704;1802;43.9122;41.8298;45.8812
565172;434;213;221;42.2074;40.6549;43.7036
564567;23849;11516;12333;42.5031;40.6765;44.2087
546691;203;112;91;40.1502;38.1875;42.5659
565211;569;286;283;42.1239;41.4406;42.8145
565229;8840;4242;4598;42.6250;40.8331;44.2782
565237;347;187;160;41.2147;40.9278;41.5500
565245;728;358;370;43.8379;41.6397;45.9649
542491;190;100;90;38.2789;36.7100;40.0222
565253;818;422;396;41.8521;41.0711;42.6843
542521;150;76;74;43.0933;40.5921;45.6622
530506;235;133;102;43.2277;41.8008;45.0882
565296;231;109;122;39.5346;38.1697;40.7541
565300;574;287;287;40.3955;38.7160;42.0749
565318;1798;917;881;42.4894;41.2514;43.7781
565342;398;204;194;42.8492;41.6716;44.0876
542440;91;50;41;42.5989;39.9400;45.8415
542539;198;107;91;47.5758;45.3131;50.2363
565393;449;231;218;42.7940;42.6818;42.9128
565415;665;330;335;44.0008;44.0030;43.9985
565431;1366;685;681;42.2445;41.2577;43.2372
565458;629;321;308;43.2679;42.0794;44.5065
565474;295;152;143;38.7949;36.9408;40.7657
565482;344;158;186;42.0029;40.3291;43.4247
565491;636;325;311;39.2296;38.2446;40.2588
565521;492;251;241;41.3923;38.9422;43.9440
565547;117;61;56;43.0128;41.5164;44.6429
565555;12847;6287;6560;43.1796;41.3320;44.9503
546721;214;107;107;41.8271;39.4907;44.1636
565598;267;135;132;44.4139;44.0111;44.8258
565601;275;136;139;45.1327;45.4926;44.7806
565610;759;407;352;43.6568;42.8882;44.5455
546828;40;29;11;43.1250;42.8448;43.8636
565679;1076;507;569;40.8866;40.2909;41.4174
565695;790;456;334;43.6544;43.5066;43.8563
565709;8695;4260;4435;42.1546;41.1383;43.1309
565717;2899;1432;1467;43.7353;41.9846;45.4441
565741;605;303;302;44.9628;43.7244;46.2053
542407;407;208;199;40.1806;40.8221;39.5101
565768;1984;1035;949;43.4254;42.3242;44.6264
565776;843;422;421;44.6079;43.7180;45.5000
565792;561;291;270;44.0276;41.7234;46.5111
565806;266;137;129;38.3759;38.0912;38.6783
565814;2928;1462;1466;42.6066;42.0595;43.1521
565831;909;468;441;42.8905;41.5577;44.3050
565849;1612;822;790;43.0968;41.5426;44.7139
565857;496;260;236;41.1673;40.3115;42.1102
565865;307;164;143;42.9137;40.8841;45.2413
565873;179;86;93;44.7291;44.5116;44.9301
565881;401;216;185;41.2506;38.7731;44.1432
565890;537;267;270;39.1034;37.1816;41.0037
565903;300;144;156;43.2600;43.2361;43.2821
565911;310;158;152;42.6677;42.3101;43.0395
542482;185;83;102;37.2297;37.9699;36.6275
565938;279;140;139;40.4176;39.4571;41.3849
565946;527;269;258;41.8928;41.4071;42.3992
565954;380;201;179;38.8289;37.7736;40.0140
565962;1565;818;747;41.2681;40.6357;41.9605
565997;451;224;227;37.2694;37.4955;37.0463
566004;514;252;262;43.4903;42.0873;44.8397
566012;273;134;139;37.9249;36.5448;39.2554
566021;1023;535;488;41.1041;39.7206;42.6209
542547;373;197;176;37.4705;37.6523;37.2670
546895;76;41;35;53.0000;52.5732;53.5000
566063;315;163;152;40.7730;40.5920;40.9671
542571;1099;563;536;39.1843;38.0151;40.4123
530581;313;160;153;38.5990;38.7750;38.4150
542628;1339;649;690;42.8002;41.3305;44.1826
566128;194;104;90;40.3763;38.9135;42.0667
546861;1410;701;709;41.9780;42.4016;41.5592
566152;636;334;302;44.4921;42.3234;46.8907
566187;610;311;299;43.6672;43.1624;44.1923
566195;407;200;207;44.7826;44.6500;44.9106
566217;631;322;309;44.0769;43.3913;44.7913
566233;578;285;293;41.6384;41.5105;41.7628
566241;558;298;260;41.7849;40.6074;43.1346
546429;118;66;52;44.0085;42.6212;45.7692
546011;903;470;433;41.2619;39.8170;42.8303
566284;597;307;290;45.2504;43.8062;46.7793
530557;129;68;61;44.5155;44.3088;44.7459
566306;661;339;322;44.1067;42.0015;46.3230
566314;2330;1139;1191;42.3906;41.8775;42.8812
566322;1416;691;725;41.0643;40.7127;41.3993
566349;969;506;463;41.3318;40.9743;41.7225
566357;760;386;374;41.3776;40.9016;41.8690
530590;554;284;270;41.3682;41.1444;41.6037
566381;356;181;175;40.9382;41.1464;40.7229
566403;549;270;279;42.5874;44.3593;40.8728
566411;157;84;73;42.2261;41.2262;43.3767
546879;452;231;221;45.6881;43.3745;48.1063
565971;18313;8790;9523;42.4611;40.5110;44.2611
566438;1355;683;672;44.8926;43.4341;46.3750
566454;995;519;476;42.4960;41.7447;43.3151
566501;401;202;199;41.0985;41.7574;40.4296
542636;122;65;57;43.4016;41.2077;45.9035
566519;571;300;271;40.7907;40.7367;40.8506
542580;435;206;229;39.7230;40.4272;39.0895
566527;378;202;176;41.3333;40.4010;42.4034
542555;125;66;59;48.2040;46.7121;49.8729
566535;447;235;212;40.7573;40.1511;41.4292
566551;2314;1175;1139;43.0488;41.6711;44.4701
566560;656;344;312;43.2759;43.0494;43.5256
566578;350;180;170;43.0486;42.1556;43.9941
566586;300;158;142;43.2033;42.2152;44.3028
566608;147;76;71;41.8469;41.3421;42.3873
566616;6386;3130;3256;41.5451;39.8192;43.2042
566624;4727;2381;2346;40.6159;39.8154;41.4284
566659;261;137;124;43.4923;43.7920;43.1613
566667;554;273;281;44.8249;42.6685;46.9199
566713;585;296;289;40.5017;40.1014;40.9118
566721;427;212;215;44.3431;43.4198;45.2535
543128;1015;506;509;40.3956;39.4130;41.3723
566829;283;149;134;44.3763;41.1577;47.9552
566853;683;370;313;43.7635;44.3162;43.1102
546178;85;42;43;44.2882;42.3810;46.1512
566870;336;177;159;38.3780;39.2740;37.3805
566896;423;206;217;39.6820;38.9951;40.3341
566918;242;126;116;49.0331;48.8889;49.1897
566926;189;102;87;44.8228;45.0784;44.5230
566934;1827;914;913;43.7425;43.3840;44.1013
546887;250;115;135;45.7120;45.1000;46.2333
566951;514;260;254;39.9728;38.8538;41.1181
530603;95;48;47;40.4895;41.0833;39.8830
566977;379;184;195;41.6372;42.9837;40.3667
566985;19047;9298;9749;42.1008;40.4734;43.6529
530565;98;45;53;40.2551;40.9889;39.6321
543012;211;102;109;43.3104;42.6961;43.8853
567019;414;212;202;43.0435;41.6179;44.5396
567043;1407;699;708;39.9151;38.8848;40.9322
567051;216;121;95;42.8889;41.7479;44.3421
567060;1279;691;588;41.0496;40.2641;41.9728
567078;258;139;119;45.1240;44.3633;46.0126
567108;99;47;52;48.1869;50.8191;45.8077
567141;706;399;307;41.4108;40.9010;42.0733
567167;450;238;212;42.3511;42.7731;41.8774
567175;2245;1157;1088;40.9388;39.9261;42.0156
567191;155;75;80;40.0226;40.4733;39.6000
567221;217;112;105;41.3848;39.5804;43.3095
567248;210;112;98;45.5619;44.9286;46.2857
567256;23661;11705;11956;43.1700;41.9036;44.4099
567264;3695;1869;1826;41.8424;40.9762;42.7289
567272;679;349;330;40.9080;40.9556;40.8576
567281;697;398;299;43.1155;42.7513;43.6003
567299;197;109;88;43.1954;42.3440;44.2500
567302;479;265;214;38.0449;36.6887;39.7243
567311;4843;2370;2473;44.8564;42.7646;46.8611
567027;66034;32454;33580;42.1613;40.4940;43.7726
567329;471;240;231;45.5000;43.9875;47.0714
567337;2178;1167;1011;34.5216;33.9833;35.1429
567345;442;215;227;41.6516;42.7651;40.5969
567353;237;140;97;43.8671;42.2929;46.1392
567361;252;133;119;45.8849;45.5301;46.2815
546437;115;55;60;41.8478;41.4273;42.2333
567426;486;259;227;42.0412;40.9556;43.2797
567451;17200;9462;7738;41.6320;40.6213;42.8679
567469;400;196;204;44.0350;44.0051;44.0637
567477;1900;944;956;45.3032;43.0784;47.5000
567485;890;460;430;42.0461;40.1348;44.0907
567507;7876;3888;3988;42.5825;41.7405;43.4035
567515;8564;4228;4336;41.5337;39.9884;43.0406
567523;1254;646;608;39.2640;38.9396;39.6086
567531;1254;654;600;39.8987;38.6483;41.2617
567558;2011;1012;999;41.8889;41.1621;42.6251
567566;1391;838;553;41.5561;41.6790;41.3698
567582;879;452;427;42.9687;43.1615;42.7646
567604;423;228;195;40.7577;39.6009;42.1103
567612;936;488;448;43.1709;41.6311;44.8482
567621;3210;1523;1687;40.9327;40.0378;41.7407
567639;12633;6229;6404;41.6752;40.3895;42.9257
567647;678;333;345;41.1549;39.9985;42.2710
567655;544;269;275;39.5294;37.9907;41.0345
546909;126;67;59;45.8571;44.4104;47.5000
567698;310;154;156;44.0387;44.4156;43.6667
567701;235;119;116;42.3426;43.1303;41.5345
567710;1060;545;515;39.5179;39.1991;39.8553
567728;183;102;81;40.7350;41.8039;39.3889
567752;2165;1090;1075;42.4104;41.5495;43.2833
567761;739;349;390;42.5934;43.1046;42.1359
567779;4728;2327;2401;43.0772;42.0118;44.1097
567787;2699;1373;1326;42.3192;41.3740;43.2979
567809;804;409;395;42.0771;40.8521;43.3456
567833;454;232;222;40.4449;40.2026;40.6982
567841;1036;544;492;42.0512;41.0257;43.1850
567442;49731;24027;25704;43.0572;41.3014;44.6985
567850;900;450;450;41.1433;39.1533;43.1333
567868;1152;582;570;42.0842;40.9845;43.2070
567876;520;263;257;41.5865;41.2376;41.9436
567884;187;102;85;40.2701;38.5490;42.3353
567931;588;308;280;43.7415;42.7240;44.8607
567957;216;110;106;40.1852;38.8636;41.5566
567973;380;192;188;42.8711;42.2656;43.4894
568007;2540;1230;1310;41.6035;40.1431;42.9748
568015;4346;2141;2205;42.4462;41.3515;43.5091
568023;1093;557;536;39.3124;38.7783;39.8675
568058;1805;910;895;42.7964;42.7220;42.8721
568091;515;266;249;44.0495;41.9361;46.3072
568104;837;437;400;41.5131;41.1316;41.9300
568147;912;489;423;38.8618;38.1667;39.6655
568155;2218;1112;1106;43.0667;41.7743;44.3662
530620;438;228;210;40.8242;39.6579;42.0905
546186;187;88;99;42.6604;42.5568;42.7525
568201;1466;748;718;41.8902;40.6404;43.1922
546925;488;252;236;42.4016;41.1984;43.6864
568287;144;72;72;43.1667;44.7361;41.5972
568295;727;387;340;42.4120;42.9910;41.7529
568309;941;499;442;41.1302;39.4760;42.9977
553697;3364;1720;1644;37.4242;37.4192;37.4294
554804;92716;45126;47590;42.3296;40.7335;43.8430
568350;2300;1119;1181;42.2222;40.7440;43.6228
555223;883;466;417;40.1512;39.8326;40.5072
568384;234;123;111;44.4573;42.2805;46.8694
561398;347;176;171;45.4654;43.1591;47.8392
561401;106;54;52;49.0566;49.9630;48.1154
561410;620;315;305;40.4000;41.1698;39.6049
561428;222;107;115;35.7613;36.0140;35.5261
561444;1353;699;654;41.1608;40.4599;41.9098
561479;4509;2242;2267;42.3456;40.5294;44.1418
561380;37525;18248;19277;41.0763;39.4780;42.5894
561495;5186;2544;2642;43.6105;41.9072;45.2506
561533;1721;854;867;42.7586;42.2389;43.2705
561541;652;344;308;42.0736;41.3605;42.8701
544337;440;225;215;39.7455;38.9356;40.5930
561584;524;266;258;39.8893;39.3421;40.4535
561592;775;407;368;37.8032;37.0012;38.6902
561606;686;346;340;41.5423;40.7948;42.3029
561614;251;132;119;41.6673;39.7424;43.8025
561622;176;83;93;41.6534;41.9819;41.3602
561665;821;416;405;40.7412;37.9712;43.5864
561681;3915;1945;1970;42.4545;41.6265;43.2721
546232;157;82;75;40.8758;40.0854;41.7400
561720;787;409;378;42.0337;40.1259;44.0979
561738;168;81;87;48.8810;49.4136;48.3851
561746;615;312;303;42.3276;41.6154;43.0611
546259;232;123;109;42.1681;39.5325;45.1422
514161;79;40;39;41.4494;40.7250;42.1923
561827;321;150;171;48.6931;50.0200;47.5292
561835;6443;3175;3268;42.4586;40.9961;43.8794
561851;307;149;158;41.5423;41.0503;42.0063
561860;11616;5570;6046;44.4560;42.4183;46.3333
561878;776;394;382;41.6482;41.2107;42.0995
561886;314;158;156;40.8822;40.9367;40.8269
561894;558;283;275;42.2706;41.9947;42.5545
514276;397;212;185;38.7343;37.7406;39.8730
561959;428;216;212;40.4439;39.4676;41.4387
561983;741;377;364;41.9561;41.3674;42.5659
561991;441;221;220;43.6905;43.9163;43.4636
530387;237;116;121;37.7236;38.4569;37.0207
562017;2137;1120;1017;39.3343;38.6179;40.1234
562025;1532;805;727;41.3525;40.3311;42.4835
513890;160;78;82;42.7125;41.9103;43.4756
562050;734;368;366;44.3937;43.3125;45.4809
546275;139;75;64;42.3705;43.3267;41.2500
562076;706;354;352;44.2521;43.0819;45.4290
562092;3992;1961;2031;40.4133;39.1017;41.6797
562106;993;507;486;42.3087;42.0069;42.6235
562114;318;168;150;41.4591;41.1964;41.7533
546283;264;140;124;40.5341;39.9214;41.2258
562131;649;320;329;41.8421;41.1844;42.4818
553638;210;114;96;36.5238;36.0088;37.1354
546267;279;148;131;43.3853;42.3041;44.6069
562173;171;90;81;44.5526;46.4333;42.4630
562203;198;93;105;43.2778;43.2097;43.3381
562220;699;336;363;40.0880;39.6310;40.5110
562238;107;56;51;39.5935;37.6964;41.6765
562246;680;357;323;40.5735;39.8754;41.3452
562262;2851;1404;1447;41.7617;40.4352;43.0487
562297;1912;956;956;42.5309;41.5617;43.5000
514195;123;64;59;43.9309;43.5313;44.3644
563528;349;180;169;42.2479;42.6778;41.7899
563536;363;180;183;38.7617;39.2722;38.2596
530425;200;104;96;38.9250;38.0192;39.9063
563552;3084;1520;1564;44.1654;42.6336;45.6541
563561;587;291;296;43.1388;41.7405;44.5135
563579;853;436;417;43.2667;40.5803;46.0755
563510;45773;21995;23778;42.6235;40.7695;44.3384
563595;1492;798;694;40.9135;40.1040;41.8444
563609;1207;597;610;38.3003;37.8317;38.7590
563617;217;106;111;44.1866;45.8868;42.5631
546585;457;232;225;48.9617;46.5172;51.4822
563633;897;479;418;44.9404;43.8987;46.1340
563641;1038;514;524;43.5222;42.7140;44.3149
563668;912;470;442;44.8673;43.6277;46.1855
563676;263;135;128;43.6901;42.8333;44.5938
563684;241;127;114;43.3880;40.5945;46.5000
563692;1889;994;895;41.7043;40.8139;42.6933
563706;1203;582;621;43.1367;41.9708;44.2295
563714;610;316;294;41.7836;41.3924;42.2041
563731;831;450;381;41.1871;40.1711;42.3871
563749;1996;1009;987;41.0511;40.4366;41.6793
563757;1053;534;519;42.2056;40.9625;43.4846
546577;462;223;239;37.7446;38.5045;37.0356
563773;174;97;77;43.1494;39.8918;47.2532
563781;932;464;468;39.0665;38.8621;39.2692
563790;2757;1412;1345;39.9806;38.3902;41.6502
563803;605;286;319;40.1645;39.5979;40.6724
563811;3756;1891;1865;40.7101;39.8083;41.6244
563820;6216;3107;3109;44.0426;42.1373;45.9468
563838;2682;1264;1418;44.3117;41.9098;46.4528
563846;105;52;53;49.9762;46.9038;52.9906
563854;905;445;460;42.4934;40.9067;44.0283
563862;507;246;261;43.0424;42.6260;43.4349
563871;6051;2917;3134;44.7072;42.8816;46.4065
563901;969;481;488;39.7776;39.6601;39.8934
563919;1043;537;506;40.3974;38.8184;42.0731
546631;690;356;334;43.0565;43.4270;42.6617
563935;940;493;447;38.9309;38.6684;39.2204
563943;120;63;57;40.6083;40.2460;41.0088
545996;323;167;156;41.3514;40.9790;41.7500
563960;2821;1432;1389;43.9488;41.3415;46.6368
544531;552;283;269;40.6304;40.0477;41.2435
546607;711;359;352;40.0134;39.1017;40.9432
530468;912;472;440;39.0384;37.2267;40.9818
563994;528;271;257;39.6837;39.0018;40.4027
564028;7476;3640;3836;42.4540;40.9673;43.8647
564036;493;261;232;41.1187;39.8333;42.5647
564044;2736;1346;1390;42.9678;41.3886;44.4971
544353;269;145;124;43.0911;43.8379;42.2177
564052;232;107;125;45.7069;45.5748;45.8200
564061;2960;1478;1482;41.7348;41.0041;42.4636
564079;234;134;100;43.9487;42.5373;45.8400
564095;7735;3880;3855;41.4789;40.1894;42.7768
564109;1020;508;512;40.8167;39.8839;41.7422
564117;6298;3116;3182;40.7726;39.3023;42.2124
561631;3667;1838;1829;41.5232;40.6170;42.4338
561657;94;47;47;49.2128;49.7128;48.7128
546658;157;83;74;44.7357;44.9096;44.5405
530484;545;287;258;38.2982;37.5906;39.0853
564133;637;302;335;43.0589;41.7351;44.2522
564141;362;185;177;40.9282;41.8514;39.9633
564168;476;230;246;42.2710;43.1783;41.4228
564176;382;208;174;39.2775;39.9087;38.5230
564184;860;441;419;40.9093;40.0442;41.8198
530433;365;201;164;42.3658;41.7090;43.1707
564206;431;220;211;42.9594;42.8273;43.0972
545937;221;98;123;42.7670;44.0000;41.7846
563889;104802;50830;53972;42.1125;40.5756;43.5600
564231;1630;821;809;39.0436;37.9507;40.1527
546593;873;448;425;41.3213;40.8371;41.8318
564265;3716;1838;1878;41.6079;40.8063;42.3924
564281;767;395;372;39.3957;39.4696;39.3172
564290;1135;576;559;41.9652;41.6233;42.3175
545953;348;174;174;42.2902;41.1322;43.4483
564303;706;353;353;41.5609;40.5453;42.5765
564311;294;146;148;41.0408;40.2055;41.8649
544345;395;208;187;40.9734;40.5144;41.4840
564354;1297;634;663;43.0582;42.1688;43.9087
544582;306;145;161;42.3856;40.3966;44.1770
564371;2819;1402;1417;41.6050;40.9494;42.2537
564397;785;403;382;43.3917;42.6241;44.2016
564401;168;87;81;40.3690;39.4310;41.3765
544477;2377;1177;1200;40.2796;40.0709;40.4842
564427;956;485;471;42.6423;41.3309;43.9926
564435;449;232;217;42.0635;39.1638;45.1636
564443;345;182;163;40.0362;40.3791;39.6534
564451;223;121;102;37.9664;36.6405;39.5392
564460;1314;668;646;36.2154;35.7994;36.6455
564494;1341;704;637;42.7118;41.5824;43.9600
564516;341;159;182;42.2859;40.8396;43.5495
564532;561;293;268;44.2683;43.2918;45.3358
564541;266;137;129;45.3609;43.8650;46.9496
544604;153;77;76;41.8399;42.6169;41.0526
576972;274;142;132;43.1241;41.8099;44.5379
576981;1096;553;543;43.0566;42.6284;43.4926
576999;854;433;421;41.0667;40.2760;41.8800
577006;587;305;282;42.7845;42.3951;43.2057
577014;238;120;118;44.2521;41.9167;46.6271
577031;210;116;94;41.9905;39.6638;44.8617
577049;115;58;57;41.9783;41.0517;42.9211
577057;580;294;286;42.5655;40.0136;45.1888
577073;680;346;334;40.7574;40.8092;40.7036
577081;1396;694;702;45.0408;44.0821;45.9886
577111;98;50;48;41.2041;39.6000;42.8750
574201;238;127;111;42.4748;38.8622;46.6081
577120;1903;955;948;41.5163;40.0330;43.0105
577146;607;317;290;43.7043;43.1246;44.3379
577154;1003;507;496;41.6565;40.3481;42.9940
577162;1633;811;822;45.8117;44.5715;47.0353
577171;472;248;224;46.0657;45.2823;46.9330
577189;239;128;111;44.6841;44.2969;45.1306
577197;5401;2654;2747;43.2213;41.5757;44.8112
577201;209;107;102;39.2703;37.8178;40.7941
577219;783;398;385;44.4017;43.0427;45.8065
577227;195;110;85;41.6333;39.4455;44.4647
577235;1658;817;841;42.0549;40.4535;43.6106
577243;493;253;240;44.8327;43.3617;46.3833
547484;198;107;91;45.9848;44.3972;47.8516
577375;362;181;181;42.4669;42.1851;42.7486
577294;952;478;474;43.3624;41.8222;44.9156
577308;5554;2755;2799;43.3995;41.4586;45.3099
573400;166;80;86;40.2169;40.9250;39.5581
573418;616;321;295;41.7208;41.0701;42.4288
577316;1770;870;900;41.4040;40.8759;41.9144
577324;442;228;214;41.5362;40.4649;42.6776
577332;582;316;266;40.5258;39.6930;41.5150
577341;652;334;318;42.0184;41.2635;42.8113
577359;1105;556;549;43.5353;42.4227;44.6621
577367;206;106;100;41.0243;36.0660;46.2800
547476;251;126;125;45.7590;44.8175;46.7080
577391;270;140;130;39.2407;38.6571;39.8692
577405;1105;556;549;44.4665;42.4209;46.5383
577413;952;472;480;42.4958;42.2606;42.7271
577421;249;129;120;42.6606;42.5155;42.8167
577430;449;242;207;42.5601;40.6033;44.8478
577448;91;54;37;42.5440;41.5370;44.0135
577456;2650;1365;1285;45.4370;43.4758;47.5202
577464;277;129;148;41.6119;40.5853;42.5068
577472;1285;643;642;42.5739;41.5731;43.5763
577499;1075;520;555;40.8060;39.6288;41.9090
577481;113;54;59;46.5796;44.3148;48.6525
576964;8353;4070;4283;43.9437;41.6880;46.0872
577529;681;342;339;43.3825;41.5848;45.1962
577545;707;363;344;44.7277;42.9298;46.6250
577553;1929;957;972;41.3429;39.9995;42.6656
577561;177;94;83;45.7542;45.0745;46.5241
577570;225;121;104;43.1444;40.3926;46.3462
577596;577;283;294;42.5416;42.2244;42.8469
577600;91;53;38;53.5220;51.0472;56.9737
577626;14420;6906;7514;44.0275;42.1281;45.7731
577642;233;119;114;42.3841;42.6933;42.0614
577651;941;465;476;42.7561;42.5280;42.9790
577669;386;201;185;45.1140;45.5746;44.6135
577677;606;309;297;42.4686;40.4612;44.5572
577685;407;208;199;45.1486;45.1250;45.1734
577693;1298;680;618;44.2203;42.7265;45.8641
577707;500;258;242;44.4080;45.6705;43.0620
577723;232;125;107;40.8664;39.5560;42.3972
569828;185;96;89;45.5595;44.1875;47.0393
569836;312;168;144;40.0353;38.4583;41.8750
569852;355;173;182;40.5310;40.6214;40.4451
569861;121;65;56;40.1116;37.8385;42.7500
569879;439;222;217;38.8850;38.3874;39.3940
569887;570;277;293;43.9772;42.3339;45.5307
569917;2394;1198;1196;41.1132;40.5968;41.6304
569925;1137;572;565;44.5536;42.4580;46.6752
569933;188;98;90;38.0532;37.8980;38.2222
569941;237;123;114;40.2004;40.3780;40.0088
569968;585;285;300;41.7068;41.6930;41.7200
569976;470;234;236;39.9787;38.8162;41.1314
569984;708;366;342;42.5367;41.2459;43.9181
569992;302;153;149;41.8940;40.9641;42.8490
570001;733;362;371;43.1030;41.7707;44.4030
570010;167;87;80;42.4521;41.8333;43.1250
570028;934;460;474;41.5246;41.2609;41.7806
570044;684;340;344;43.2763;42.8971;43.6512
569810;92939;44679;48260;44.3666;42.5645;46.0349
570052;185;98;87;45.1270;42.3878;48.2126
570087;392;195;197;40.2577;37.3256;43.1599
573621;222;110;112;40.5225;38.0000;43.0000
570109;5501;2700;2801;43.0714;42.0604;44.0459
570125;264;137;127;38.3636;37.3102;39.5000
570133;467;241;226;42.4743;41.2178;43.8142
576352;304;165;139;40.2105;38.8697;41.8022
570150;217;108;109;40.6152;40.6019;40.6284
570168;404;197;207;46.5594;44.0533;48.9444
573710;259;134;125;38.0946;39.0970;37.0200
570176;341;169;172;43.4208;40.5947;46.1977
570184;349;174;175;42.5057;42.4080;42.6029
570192;398;192;206;41.5603;41.0677;42.0194
570206;602;295;307;42.1960;41.4220;42.9397
570214;380;184;196;39.5500;38.1522;40.8622
576433;349;161;188;43.3109;41.3944;44.9521
570222;222;118;104;41.5225;42.7627;40.1154
570231;952;464;488;41.3697;40.5496;42.1496
570249;898;463;435;42.1949;40.7657;43.7161
570257;167;72;95;44.6796;47.1667;42.7947
570265;593;300;293;38.3449;38.5233;38.1621
570273;289;155;134;42.6280;39.8871;45.7985
570290;159;89;70;50.0660;44.6236;56.9857
570303;418;213;205;40.5837;38.8568;42.3780
570311;608;304;304;41.1168;39.5658;42.6678
570320;721;345;376;42.4417;40.9000;43.8564
570354;128;62;66;46.8047;47.6935;45.9697
570362;511;256;255;43.8973;42.5820;45.2176
573779;220;113;107;41.1000;40.2699;41.9766
570397;585;308;277;43.6966;42.4968;45.0307
570401;235;116;119;43.6830;41.4483;45.8613
570419;382;208;174;40.9241;38.9423;43.2931
570427;174;80;94;44.2989;43.8875;44.6489
570435;415;189;226;42.6590;43.3466;42.0841
570443;355;180;175;42.1676;40.2000;44.1914
570451;2348;1179;1169;41.9191;39.9317;43.9234
570478;986;485;501;41.9341;41.0320;42.8074
570494;416;209;207;42.3101;40.4282;44.2101
570508;6935;3376;3559;43.9161;42.1834;45.5598
548065;286;153;133;42.5210;40.0817;45.3271
570516;332;165;167;43.7380;41.5061;45.9431
570524;381;187;194;39.8727;38.2166;41.4691
570532;515;261;254;39.2534;38.0824;40.4567
570541;159;80;79;40.0472;39.6250;40.4747
570567;281;135;146;42.2473;42.1593;42.3288
570575;261;123;138;40.9713;42.5650;39.5507
570648;615;318;297;43.0902;40.9843;45.3451
570656;1079;530;549;41.2386;40.9264;41.5401
570672;1917;950;967;40.9502;39.8242;42.0564
570681;335;171;164;42.0284;40.8684;43.2378
530671;63;29;34;47.3413;49.9828;45.0882
573531;108;49;59;49.1296;49.8469;48.5339
570702;150;87;63;41.4200;40.2931;42.9762
570711;183;94;89;41.1393;38.8511;43.5562
570729;134;72;62;45.4851;45.2222;45.7903
570745;689;342;347;40.9398;38.6462;43.2003
573191;322;149;173;47.0559;45.0168;48.8121
570796;442;238;204;41.4751;40.7311;42.3431
570800;644;325;319;40.2081;38.5092;41.9389
570834;1046;501;545;42.3107;39.7635;44.6523
570851;513;247;266;43.2934;42.0911;44.4098
570869;1523;804;719;44.2859;43.6853;44.9576
570877;2913;1459;1454;42.5288;40.3149;44.7503
570885;502;262;240;41.3227;39.7557;43.0333
570907;222;110;112;39.5270;38.9000;40.1429
570915;138;72;66;44.5145;45.0972;43.8788
573132;413;205;208;43.8729;43.8951;43.8510
570931;2100;1030;1070;40.1600;39.6097;40.6897
570958;297;160;137;43.4731;41.8813;45.3321
570966;395;187;208;41.8873;40.9439;42.7356
548154;327;174;153;40.5703;39.9368;41.2908
571008;447;236;211;41.0459;40.2712;41.9123
571016;117;62;55;48.3291;44.7903;52.3182
571024;361;190;171;45.1427;42.8474;47.6930
571041;5771;2835;2936;42.3844;41.0474;43.6754
571059;268;138;130;41.0672;41.1957;40.9308
513717;335;168;167;43.2940;40.8571;45.7455
571083;442;210;232;42.5814;40.7952;44.1983
548057;62;30;32;44.9839;39.7667;49.8750
571091;1797;884;913;41.1105;40.0645;42.1232
571105;402;211;191;40.3831;38.5948;42.3586
571113;1703;864;839;37.4154;36.7454;38.1055
548677;85;50;35;41.5471;39.1200;45.0143
571130;239;109;130;40.1987;42.0321;38.6615
573744;158;87;71;46.9873;44.4770;50.0634
553701;165;87;78;45.2152;43.1437;47.5256
572667;207;107;100;43.3599;41.5093;45.3400
572675;268;143;125;39.8097;37.9126;41.9800
548901;126;61;65;45.1825;43.7295;46.5462
572705;248;127;121;41.9919;42.4134;41.5496
548979;96;51;45;39.5313;36.7941;42.6333
549100;161;82;79;40.0963;39.4878;40.7278
549070;122;59;63;39.9918;39.3305;40.6111
548855;254;134;120;44.4606;44.1343;44.8250
548952;157;76;81;45.2325;43.3553;46.9938
573353;162;78;84;41.8519;42.6667;41.0952
549282;285;138;147;38.4930;40.4855;36.6224
572772;341;165;176;41.1334;40.0939;42.1080
572781;771;384;387;40.7879;39.4792;42.0866
548995;161;76;85;42.6491;42.7368;42.5706
572811;239;115;124;45.4414;45.5435;45.3468
572829;719;358;361;43.4736;42.1117;44.8241
549118;59;28;31;33.6186;32.1071;34.9839
572837;577;300;277;41.5503;40.6967;42.4747
549088;45;22;23;40.7444;38.7273;42.6739
573337;250;124;126;44.3920;43.2016;45.5635
572900;600;318;282;43.5450;41.7704;45.5461
572918;543;274;269;42.6694;42.4270;42.9164
572926;8533;4147;4386;44.5444;42.8308;46.1646
549355;226;114;112;42.7965;42.3509;43.2500
572969;628;303;325;42.8376;41.2261;44.3400
549037;202;107;95;44.2871;42.5654;46.2263
549223;173;86;87;39.2341;39.8488;38.6264
572993;400;198;202;41.4125;41.1515;41.6683
572659;16717;8174;8543;43.3412;41.7876;44.8276
573001;595;315;280;41.4529;39.5000;43.6500
549151;198;97;101;43.2727;43.4175;43.1337
549312;170;85;85;44.0647;42.5353;45.5941
549169;221;116;105;40.3235;39.1552;41.6143
573043;272;149;123;42.7500;40.5872;45.3699
573051;404;208;196;39.8292;39.1490;40.5510
573060;2112;1070;1042;42.8589;40.7963;44.9770
548928;37;16;21;45.6081;45.6250;45.5952
548944;144;73;71;39.9097;39.7740;40.0493
572136;177;94;83;43.7316;42.2872;45.3675
572047;57;29;28;50.6754;45.4655;56.0714
573094;3658;1837;1821;43.9486;41.6769;46.2403
573108;1867;936;931;42.4459;40.1165;44.7879
573116;513;256;257;43.7300;41.9180;45.5350
573124;787;393;394;43.1518;41.6145;44.6853
573086;216;109;107;43.3333;40.9404;45.7710
573141;303;155;148;41.8993;40.6290;43.2297
573159;582;294;288;42.9175;40.9592;44.9167
573167;488;244;244;43.5307;42.4877;44.5738
573175;923;463;460;42.3776;40.9060;43.8587
548863;293;147;146;40.2235;40.3299;40.1164
573205;513;261;252;44.6442;41.8410;47.5476
573213;541;261;280;46.2967;43.8525;48.5750
573230;342;170;172;40.7018;40.9647;40.4419
549207;170;88;82;41.8529;41.6591;42.0610
573248;9072;4432;4640;44.2894;42.6507;45.8545
549185;69;32;37;41.0797;42.1875;40.1216
548910;112;51;61;37.5446;37.9902;37.1721
573264;235;125;110;40.2617;39.7640;40.8273
573272;1349;692;657;44.1857;42.5679;45.8896
573281;96;53;43;42.8958;39.9151;46.5698
573299;1285;638;647;44.2992;43.2806;45.3037
548871;48;24;24;42.8958;40.8333;44.9583
573311;654;327;327;42.2706;41.8609;42.6804
573329;456;233;223;43.8728;42.9335;44.8543
573345;259;132;127;41.0869;41.0000;41.1772
573370;436;209;227;43.2110;42.8349;43.5573
549274;97;53;44;40.7990;39.2170;42.7045
573221;317;153;164;42.0300;43.5915;40.5732
548898;120;62;58;39.4167;37.8226;41.1207
573442;263;136;127;45.2072;45.5956;44.7913
573451;301;152;149;43.3605;43.9342;42.7752
548961;97;49;48;46.6340;45.1939;48.1042
572144;119;65;54;46.8697;44.9154;49.2222
573469;541;263;278;43.2153;39.9525;46.3022
572187;136;70;66;48.6397;44.8143;52.6970
573477;297;164;133;43.1296;40.9207;45.8534
573361;99;51;48;45.0657;46.0490;44.0208
573493;2382;1165;1217;43.3321;41.8262;44.7736
573507;2087;1046;1041;42.3788;41.7457;43.0149
530735;182;90;92;43.3297;44.1667;42.5109
549096;322;156;166;40.5807;40.0962;41.0361
573523;267;138;129;40.9494;39.8116;42.1667
573540;279;137;142;40.3602;40.1058;40.6056
548880;222;116;106;44.2477;42.2845;46.3962
573302;97;48;49;42.1289;43.0417;41.2347
573256;197;99;98;43.0127;42.0859;43.9490
572756;158;87;71;43.0696;42.0402;44.3310
573612;272;138;134;43.5000;43.5290;43.4701
573639;341;171;170;42.1188;41.4064;42.8353
573647;120;64;56;37.9333;34.4375;41.9286
573655;449;223;226;41.5290;41.3565;41.6991
573663;295;129;166;43.1780;44.9109;41.8313
573671;152;79;73;41.0789;40.2595;41.9658
573680;334;171;163;44.7605;43.9444;45.6166
573698;306;154;152;39.2222;38.9805;39.4671
573701;1390;717;673;42.9626;41.3661;44.6634
573728;201;106;95;39.5249;37.1132;42.2158
573736;393;212;181;41.1336;39.6887;42.8260
573752;348;167;181;40.9224;40.0509;41.7265
573761;220;123;97;43.8864;41.3049;47.1598
572128;152;85;67;44.1579;43.7000;44.7388
573795;244;117;127;38.3402;37.0812;39.5000
549029;95;56;39;38.5842;34.3571;44.6538
573809;862;438;424;42.7471;40.6598;44.9033
549193;124;67;57;45.0645;42.9627;47.5351
573183;150;81;69;43.6133;43.3272;43.9493
573825;1321;681;640;42.0344;40.7996;43.3484
573833;258;134;124;41.4341;41.3955;41.4758
573841;124;61;63;45.2016;48.6475;41.8651
573850;225;110;115;47.9667;46.2182;49.6391
547786;503;238;265;45.0865;44.6723;45.4585
573884;587;301;286;40.1797;38.8156;41.6154
573892;1007;507;500;41.9489;40.4231;43.4960
573906;203;106;97;46.9729;44.3962;49.7887
573914;347;176;171;41.4942;40.9261;42.0789
573922;7370;3560;3810;43.2847;41.2256;45.2087
573931;249;130;119;43.8293;41.6000;46.2647
547751;356;181;175;42.7753;40.7873;44.8314
573957;486;244;242;42.1029;40.6516;43.5661
505099;202;107;95;41.4158;40.3131;42.6579
573965;8360;4142;4218;43.5876;41.8648;45.2793
573973;523;249;274;41.6778;41.6406;41.7117
573981;290;146;144;41.5724;42.0685;41.0694
573990;5047;2444;2603;44.6928;42.6792;46.5834
574015;658;329;329;42.3267;39.8799;44.7736
574023;772;372;400;44.0453;42.8387;45.1675
574031;593;299;294;45.1138;43.6237;46.6293
574040;427;213;214;40.9028;40.6596;41.1449
574058;501;258;243;42.5858;42.3876;42.7963
574066;508;259;249;41.1969;39.4768;42.9859
547531;145;84;61;44.1828;42.9762;45.8443
574074;560;280;280;42.5161;41.9464;43.0857
574082;6098;2941;3157;44.6428;43.3711;45.8275
574163;198;99;99;39.0556;34.9040;43.2071
574112;760;390;370;42.1632;40.3538;44.0703
574121;12378;6130;6248;42.3127;40.6577;43.9365
574139;755;364;391;39.6788;37.8269;41.4028
574147;155;88;67;45.1581;43.4773;47.3657
574155;453;241;212;42.1137;40.2137;44.2736
574546;1077;561;516;42.3654;41.4572;43.3527
574171;433;226;207;40.2252;39.2345;41.3068
574180;304;160;144;39.0625;36.8750;41.4931
547701;72;37;35;43.5000;44.3919;42.5571
573388;107;54;53;45.4065;45.4074;45.4057
574210;1092;556;536;45.0723;44.5647;45.5989
574228;507;264;243;45.5316;45.6212;45.4342
574236;132;64;68;46.1970;46.0625;46.3235
574244;250;133;117;40.8120;39.4023;42.4145
574252;2387;1157;1230;45.3328;44.1137;46.4797
574261;588;305;283;40.1344;38.5721;41.8180
573868;19897;9591;10306;44.0193;42.0144;45.8851
574279;9398;4550;4848;45.6191;43.9387;47.1962
574287;851;421;430;40.3002;39.6876;40.9000
574295;339;165;174;41.4587;39.1061;43.6897
574317;342;177;165;44.1140;43.5282;44.7424
574341;4049;1984;2065;44.5158;42.4808;46.4709
574350;1231;634;597;40.0556;38.7886;41.4012
574368;208;101;107;40.7596;41.0545;40.4813
574376;705;352;353;39.2759;38.3977;40.1516
574384;380;195;185;43.1868;42.9154;43.4730
574406;642;320;322;42.1090;41.6750;42.5404
530786;227;101;126;38.0991;38.1634;38.0476
547727;110;56;54;43.7364;42.5000;45.0185
574422;307;155;152;43.8518;42.6548;45.0724
574431;267;135;132;40.7734;40.2704;41.2879
574457;296;145;151;41.8311;41.1069;42.5265
574465;657;346;311;43.9155;42.4191;45.5804
574481;1135;561;574;41.1167;41.1542;41.0801
574490;411;220;191;40.9501;40.0773;41.9555
547654;178;90;88;47.3146;45.5889;49.0795
574511;300;153;147;42.1067;41.3627;42.8810
574538;1616;850;766;44.8601;42.7024;47.2546
574554;746;370;376;42.4853;41.7000;43.2580
574562;735;368;367;42.9571;42.5380;43.3774
574571;429;215;214;40.9452;41.2907;40.5981
547646;2354;1147;1207;43.7859;43.6866;43.8803
574589;318;172;146;44.3396;42.7907;46.1644
547743;326;171;155;42.2975;42.9444;41.5839
547565;184;95;89;39.3098;37.7632;40.9607
574601;389;189;200;39.8805;38.4841;41.2000
574627;146;70;76;40.0479;41.4143;38.7895
574635;284;151;133;40.7007;40.7914;40.5977
574643;516;257;259;41.3547;40.6984;42.0058
574651;585;318;267;37.7427;36.1730;39.6124
574660;453;239;214;38.4338;37.5335;39.4393
574686;656;327;329;40.7012;39.4969;41.8982
574694;562;270;292;43.2722;42.5852;43.9075
574708;289;151;138;38.1644;38.5066;37.7899
576077;978;480;498;43.6738;42.6104;44.6988
576085;392;206;186;43.2551;40.1311;46.7151
576093;201;97;104;41.6045;40.7165;42.4327
576107;700;361;339;40.4843;38.9404;42.1283
576115;212;98;114;47.4906;45.8061;48.9386
576123;570;288;282;42.5386;42.2465;42.8369
576131;2094;1008;1086;44.2178;41.8214;46.4420
576140;398;207;191;41.4095;41.2488;41.5838
576166;267;138;129;43.7060;42.1667;45.3527
576174;219;111;108;41.5548;41.2928;41.8241
576182;1667;871;796;42.0969;40.6102;43.7236
576191;1035;504;531;43.7077;44.2183;43.2232
576204;784;405;379;41.7832;40.5667;43.0831
576212;1953;957;996;39.0253;38.1750;39.8424
576221;611;300;311;40.5442;39.6133;41.4421
576247;552;276;276;44.6196;44.3261;44.9130
576263;863;442;421;40.9693;39.6199;42.3860
576271;6723;3296;3427;43.6575;42.3073;44.9561
576280;128;66;62;43.3125;42.6212;44.0484
576301;1789;897;892;44.0344;42.8445;45.2309
548642;360;187;173;40.0083;39.2166;40.8642
576310;230;124;106;46.1174;44.5968;47.8962
548791;91;51;40;42.5989;42.6176;42.5750
548782;98;45;53;40.5510;39.4111;41.5189
576328;113;54;59;43.6150;40.0185;46.9068
576336;1058;550;508;39.9707;39.6927;40.2717
576361;6145;2998;3147;43.7417;42.6998;44.7342
576387;151;79;72;39.9305;38.7025;41.2778
576395;241;121;120;42.1058;42.7975;41.4083
576409;239;116;123;38.9268;40.5690;37.3780
548685;97;55;42;40.6031;39.7909;41.6667
576425;1706;973;733;41.0856;39.8597;42.7128
576441;335;171;164;40.3746;39.5526;41.2317
548651;162;79;83;38.9383;38.1329;39.7048
576450;708;372;336;39.8870;39.1559;40.6964
576468;651;331;320;41.3833;40.8746;41.9094
576476;578;285;293;39.3702;37.9842;40.7184
576492;617;329;288;42.5810;41.5486;43.7604
576506;264;134;130;41.1856;42.0000;40.3462
576522;170;88;82;43.6824;41.1818;46.3659
576549;215;111;104;40.5605;41.2387;39.8365
576557;231;123;108;44.4437;42.7195;46.4074
576565;492;246;246;42.9411;41.4472;44.4350
576581;478;239;239;41.2050;41.0188;41.3912
576573;420;220;200;43.8905;42.6364;45.2700
576590;3107;1522;1585;43.8225;41.6754;45.8842
576603;204;104;100;39.2157;39.0481;39.3900
576611;298;142;156;40.2651;43.0563;37.7244
576620;496;247;249;41.1935;41.1883;41.1988
576654;569;303;266;38.5984;38.2393;39.0075
576662;697;340;357;39.8501;39.3824;40.2955
548723;138;67;71;38.2826;38.3209;38.2465
576671;997;481;516;43.0045;42.4667;43.5058
548758;54;27;27;50.2778;48.8704;51.6852
576689;636;302;334;45.6274;42.5232;48.4341
548669;272;139;133;41.5772;43.9101;39.1391
576701;2022;1020;1002;42.1503;39.9127;44.4281
576727;424;222;202;41.8090;39.4054;44.4505
576069;10999;5266;5733;43.0707;41.4670;44.5438
576735;90;57;33;40.0444;38.7982;42.1970
576743;224;127;97;41.6339;40.1850;43.5309
576751;432;212;220;40.2569;38.6085;41.8455
576778;1121;561;560;42.3573;41.4251;43.2911
576786;883;441;442;42.1172;40.7993;43.4321
576794;133;59;74;43.5827;45.1610;42.3243
576808;2239;1159;1080;42.7126;41.1359;44.4046
548693;161;84;77;42.9907;43.0119;42.9675
576816;423;209;214;40.8853;40.1220;41.6308
576824;741;377;364;41.8347;41.3647;42.3214
576832;289;154;135;37.6453;35.8442;39.7000
576841;349;174;175;42.3567;39.9598;44.7400
576859;6055;2970;3085;43.5566;41.8529;45.1969
576875;292;149;143;43.5068;41.9899;45.0874
576883;4567;2304;2263;43.3680;41.3824;45.3895
576891;733;369;364;41.7674;41.0881;42.4560
548707;154;79;75;41.8182;39.7532;43.9933
576921;624;326;298;43.8365;43.0859;44.6577
576930;259;131;128;40.4073;38.5763;42.2813
576948;197;109;88;38.6726;38.8853;38.4091
576956;518;258;260;39.3320;39.2248;39.4385
579041;775;416;359;42.7116;40.4375;45.3468
579050;924;469;455;41.5909;40.4424;42.7747
579068;1353;693;660;43.0839;40.9257;45.3500
579076;156;73;83;45.7179;46.4315;45.0904
579092;357;198;159;44.3431;40.8889;48.6447
548821;187;103;84;44.4572;42.6165;46.7143
579106;407;205;202;41.7310;41.5293;41.9356
579114;683;354;329;44.1164;43.5847;44.6884
579122;998;493;505;42.7495;42.2039;43.2822
554863;402;208;194;40.2985;38.9231;41.7732
579149;275;142;133;41.2491;42.7535;39.6429
579157;693;347;346;41.7035;40.2723;43.1387
579165;793;396;397;40.5643;40.4949;40.6335
579173;378;192;186;41.1243;41.0573;41.1935
579181;372;190;182;45.6747;45.1684;46.2033
579190;646;318;328;42.7585;42.2138;43.2866
579203;15550;7510;8040;44.8363;43.3194;46.2531
579211;1045;536;509;40.8167;40.0429;41.6316
579220;991;494;497;41.5868;41.4960;41.6771
579238;429;229;200;44.8660;43.6921;46.2100
579254;370;180;190;40.4459;38.2167;42.5579
579262;979;495;484;43.3376;42.5687;44.1240
579271;320;175;145;42.8656;41.7514;44.2103
579297;4369;2133;2236;43.7701;41.8727;45.5801
579301;224;117;107;41.8482;41.4231;42.3131
579319;1034;523;511;42.6248;41.9015;43.3650
579327;592;303;289;44.5625;42.7607;46.4516
579335;658;331;327;42.5426;41.9864;43.1055
579351;690;346;344;44.8957;43.5029;46.2965
579378;576;303;273;43.0451;42.6716;43.4597
579386;233;111;122;40.6245;40.0946;41.1066
579394;521;274;247;41.4885;39.8796;43.2733
579408;261;135;126;44.2356;43.8926;44.6032
530808;192;102;90;43.9948;43.8824;44.1222
579416;270;136;134;42.5296;42.1471;42.9179
579424;555;294;261;42.2964;41.2619;43.4617
548804;385;184;201;45.9883;43.3750;48.3806
579432;1815;932;883;40.4796;39.3337;41.6891
579441;186;88;98;47.3978;46.2500;48.4286
579475;363;184;179;44.4146;41.3967;47.5168
579483;178;96;82;44.2079;41.6250;47.2317
546470;180;92;88;39.5222;38.2500;40.8523
579505;142;83;59;38.7183;39.2349;37.9915
579513;1509;746;763;43.6166;42.7212;44.4921
579530;191;96;95;42.3743;41.8542;42.9000
579548;2308;1185;1123;41.8449;40.2316;43.5472
579556;1191;598;593;46.1742;44.7040;47.6568
579564;761;389;372;39.9534;38.9036;41.0511
579581;648;347;301;43.3657;43.1542;43.6096
579599;1257;626;631;41.4968;39.9377;43.0436
579602;591;308;283;40.1210;40.3409;39.8816
579629;971;460;511;41.8388;40.1739;43.3376
579637;2979;1487;1492;44.4141;42.6574;46.1649
579645;2172;1141;1031;43.2560;41.5298;45.1663
548812;55;22;33;47.9727;52.2273;45.1364
579661;607;311;296;41.0568;40.0659;42.0980
579696;218;113;105;40.6284;40.2699;41.0143
579726;369;184;185;41.1016;40.8641;41.3378
579734;2081;1039;1042;46.2314;44.2449;48.2121
579742;1098;535;563;42.5146;42.3150;42.7043
579751;93;47;46;38.5108;39.5000;37.5000
579025;30234;14685;15549;43.2942;41.4647;45.0220
579769;448;235;213;42.1719;41.3255;43.1056
579777;5639;2721;2918;43.7637;41.8852;45.5154
579785;1287;667;620;43.3617;42.8658;43.8952
579793;230;122;108;42.9348;42.6393;43.2685
574597;209;109;100;40.9689;39.4817;42.5900
579815;1470;758;712;40.8728;40.4855;41.2851
579823;548;273;275;40.0620;40.0861;40.0382
579831;363;185;178;43.4421;41.6568;45.2978
579858;12340;5978;6362;43.8637;42.2039;45.4233
548839;144;71;73;44.0278;43.8662;44.1849
548847;121;58;63;43.3843;42.0345;44.6270
579866;203;101;102;40.7118;41.7871;39.6471
579874;3136;1538;1598;44.5523;43.0494;45.9987
571181;536;291;245;45.3638;43.1014;48.0510
573949;84;40;44;37.1310;40.4750;34.0909
505005;431;217;214;43.0081;41.8502;44.1822
571202;640;326;314;43.5750;40.7485;46.5096
547867;136;68;68;45.4632;43.8088;47.1176
571229;180;102;78;43.9889;43.3431;44.8333
571237;204;106;98;43.4510;43.1509;43.7755
571245;450;245;205;39.5889;38.0020;41.4854
571253;257;130;127;47.8268;45.6231;50.0827
571270;331;175;156;41.1677;39.8314;42.6667
571296;119;62;57;46.3571;46.7742;45.9035
571300;135;74;61;45.6926;45.3919;46.0574
505030;231;120;111;40.0108;39.1250;40.9685
504301;402;196;206;39.0622;38.6378;39.4660
504955;173;99;74;41.3266;42.2475;40.0946
571377;233;120;113;44.4828;44.3583;44.6150
571385;4856;2337;2519;43.9415;41.8838;45.8505
571393;9642;4685;4957;43.8682;41.9894;45.6438
571407;191;94;97;44.5995;43.3404;45.8196
547794;79;40;39;43.7911;45.8000;41.7308
571440;800;407;393;41.6100;39.2371;44.0674
571458;159;84;75;45.4119;44.2738;46.6867
571466;405;204;201;42.0975;40.7843;43.4303
571474;433;215;218;47.6016;46.5326;48.6560
571482;144;76;68;42.9306;43.4474;42.3529
571491;2026;1027;999;40.9304;39.6548;42.2417
571504;342;174;168;44.0117;41.1552;46.9702
571539;3131;1539;1592;42.9583;41.3363;44.5264
571547;1254;610;644;42.7504;41.6541;43.7888
571164;23168;11279;11889;42.6750;40.8657;44.3915
547816;454;223;231;40.2974;39.9305;40.6515
571563;432;211;221;44.3333;45.2583;43.4502
571571;795;400;395;40.5428;39.3675;41.7329
571580;257;127;130;42.3171;40.6417;43.9538
573787;393;202;191;38.4618;36.8366;40.1806
574007;145;74;71;45.9759;44.7027;47.3028
571610;662;326;336;39.2900;39.7301;38.8631
571628;361;169;192;40.5028;38.7722;42.0260
571652;148;76;72;45.1757;44.5526;45.8333
571661;1421;720;701;41.1151;40.0792;42.1790
547824;116;60;56;43.6897;40.2833;47.3393
504807;274;129;145;40.9453;40.8256;41.0517
571709;160;78;82;40.3375;42.1026;38.6585
571725;81;45;36;43.9074;40.1444;48.6111
571733;152;81;71;42.4079;42.2037;42.6408
547832;252;119;133;40.1151;38.8445;41.2519
547875;250;124;126;45.6440;44.6532;46.6190
571750;153;82;71;42.7876;42.2805;43.3732
571768;869;435;434;42.4505;41.1253;43.7788
571776;2594;1286;1308;42.3319;41.1260;43.5176
571822;270;140;130;48.3704;49.2571;47.4154
571831;1311;660;651;42.1995;41.7076;42.6982
571857;346;169;177;43.9884;42.6243;45.2910
571873;740;377;363;41.1581;38.2268;44.2025
554847;339;175;164;41.1254;39.2429;43.1341
571890;127;64;63;42.2008;41.0938;43.3254
571903;627;330;297;40.0901;39.5333;40.7088
571911;1676;835;841;41.8013;40.1263;43.4643
571962;779;406;373;41.2279;40.2143;42.3311
574104;203;105;98;39.7118;39.4048;40.0408
554952;271;146;125;44.2970;41.4658;47.6040
572004;241;123;118;42.6577;41.8902;43.4576
572039;251;133;118;48.2450;47.0940;49.5424
572063;257;135;122;41.5700;38.4333;45.0410
572071;1415;718;697;40.4576;38.6142;42.3565
572080;2093;1060;1033;43.2262;41.9972;44.4874
572098;825;403;422;41.0418;38.8499;43.1351
572101;417;212;205;43.3825;43.0660;43.7098
572110;212;119;93;44.0849;42.3235;46.3387
556882;820;402;418;38.5305;37.9851;39.0550
572152;367;189;178;41.0777;39.5212;42.7303
572161;1697;825;872;43.7976;42.8430;44.7007
572179;1375;691;684;40.6229;39.3828;41.8757
547808;288;156;132;39.1007;37.0128;41.5682
572217;489;250;239;42.3609;41.1360;43.6423
572225;1737;899;838;46.5910;44.9549;48.3461
572241;5047;2475;2572;43.7901;42.5073;45.0245
572268;4217;2113;2104;43.7044;42.2336;45.1816
573817;130;66;64;40.8231;41.1061;40.5313
572276;992;506;486;36.6230;36.6403;36.6049
547891;399;193;206;40.9586;41.9560;40.0243
572314;171;85;86;46.2368;44.4882;47.9651
572322;449;229;220;45.0434;43.7402;46.4000
572331;463;245;218;42.4071;41.5980;43.3165
572349;878;433;445;42.6139;41.3383;43.8551
572381;327;164;163;43.4235;42.5915;44.2607
572390;938;476;462;41.9765;40.7374;43.2532
572403;181;91;90;43.3343;41.1374;45.5556
572411;3059;1551;1508;43.8416;42.0687;45.6651
504921;299;149;150;41.8545;41.3926;42.3133
572420;605;295;310;41.0818;39.6932;42.4032
530697;145;77;68;44.4172;42.2403;46.8824
572446;485;247;238;41.7804;39.9656;43.6639
572454;304;153;151;41.5757;41.3693;41.7848
572462;547;283;264;43.3373;41.5883;45.2121
572471;319;161;158;41.8574;42.3571;41.3481
572497;451;231;220;43.0854;42.5779;43.6182
572501;418;215;203;42.9306;39.8721;46.1700
572527;226;105;121;46.2655;47.1857;45.4669
572535;349;183;166;44.1934;43.4727;44.9880
572543;156;77;79;46.4423;47.1753;45.7278
572551;684;343;341;44.5336;43.6079;45.4648
547841;199;93;106;44.6809;47.4032;42.2925
572578;1062;546;516;42.6092;41.8571;43.4050
547859;113;57;56;44.4823;45.2895;43.6607
573876;287;142;145;43.7857;44.6408;42.9483
574091;130;63;67;46.1846;47.2302;45.2015
572641;269;143;126;45.8829;43.5699;48.5079
574724;267;131;136;37.0693;36.6603;37.4632
574741;313;159;154;40.7780;39.3805;42.2208
574783;269;132;137;43.6190;43.1212;44.0985
574791;224;111;113;46.5670;43.9685;49.1195
574805;1040;540;500;43.2721;41.2389;45.4680
574813;226;109;117;43.0354;42.9679;43.0983
574821;83;42;41;41.2470;41.0714;41.4268
574830;393;189;204;42.5280;42.7593;42.3137
574848;1549;787;762;39.0771;38.6995;39.4672
572799;237;125;112;36.7489;34.6920;39.0446
574856;1162;577;585;41.5740;41.1083;42.0333
574864;459;239;220;38.8159;37.1946;40.5773
572896;616;298;318;36.0698;35.4597;36.6415
574899;2367;1253;1114;39.5435;38.1840;41.0727
574902;399;210;189;41.3947;38.8571;44.2143
574911;2050;1042;1008;41.5322;40.2255;42.8829
574929;973;465;508;38.6408;37.9452;39.2776
574953;534;267;267;37.2397;37.6423;36.8371
572977;284;133;151;40.3169;40.8910;39.8113
574961;275;136;139;44.1400;42.7574;45.4928
574988;6581;3232;3349;43.2386;41.4663;44.9491
573019;57;31;26;42.7456;40.1452;45.8462
574996;2068;1023;1045;42.0372;40.4990;43.5431
575011;1036;519;517;40.5145;39.0761;41.9584
575046;229;109;120;41.1026;40.9312;41.2583
575054;1171;559;612;42.6477;41.3909;43.7958
575062;352;180;172;40.0199;37.9278;42.2093
572764;103;51;52;41.6650;39.6176;43.6731
575071;2962;1450;1512;43.1374;41.8979;44.3261
575089;721;379;342;41.8814;40.2704;43.6667
575097;215;110;105;42.0674;39.1727;45.1000
575101;320;159;161;43.8688;41.6384;46.0714
575119;235;112;123;42.1298;43.2679;41.0935
575127;171;93;78;39.1140;36.2312;42.5513
575135;246;133;113;41.0203;40.3421;41.8186
575143;385;201;184;41.0766;40.6045;41.5924
575151;204;104;100;42.7255;43.1058;42.3300
575178;638;318;320;46.5533;45.0157;48.0813
575194;430;230;200;43.5977;41.2913;46.2500
575232;550;282;268;39.0873;37.8865;40.3507
572861;248;133;115;45.2379;43.0940;47.7174
573515;336;173;163;39.8095;39.1069;40.5552
575259;216;110;106;38.6019;38.6091;38.5943
572845;134;72;62;43.7090;42.0833;45.5968
574767;3543;1760;1783;42.0549;41.1159;42.9818
575305;584;310;274;39.8767;39.1097;40.7445
575313;419;210;209;41.5979;39.1238;44.0837
575330;149;85;64;42.9832;44.5706;40.8750
572802;128;63;65;42.5234;40.6429;44.3462
575372;1262;633;629;40.0000;39.9107;40.0898
575381;178;84;94;43.4213;44.1786;42.7447
573035;79;40;39;51.6772;49.2250;54.1923
575399;1862;892;970;45.5682;43.6996;47.2866
572870;708;366;342;33.7698;33.1230;34.4620
573078;161;78;83;42.8602;42.9744;42.7530
575429;2598;1276;1322;40.0793;39.8002;40.3487
575437;1097;533;564;41.1062;41.1135;41.0993
575445;938;469;469;43.4936;41.2846;45.7026
555134;91727;45276;46451;43.3340;41.4679;45.1529
572942;98;55;43;41.0306;39.5727;42.8953
575461;271;145;126;40.0387;39.8034;40.3095
575470;110;58;52;38.3727;37.3793;39.4808
572951;167;80;87;42.7455;42.9250;42.5805
572853;115;57;58;37.7348;38.6053;36.8793
575500;9880;5005;4875;42.7538;41.4019;44.1418
575518;217;118;99;44.8272;44.3559;45.3889
575526;87;46;41;46.1437;46.9565;45.2317
575534;567;299;268;45.5353;45.9816;45.0373
575551;603;288;315;41.5216;40.1667;42.7603
575569;262;134;128;45.6756;43.3806;48.0781
575577;897;477;420;40.0307;38.5147;41.7524
575593;1326;629;697;43.4321;40.7162;45.8831
575607;1355;681;674;43.8048;42.1167;45.5104
575615;195;121;74;42.6077;43.0124;41.9459
575623;587;279;308;42.4012;41.1989;43.4903
575640;3988;1999;1989;41.0218;39.9207;42.1285
575658;442;222;220;41.8891;39.5676;44.2318
575666;263;146;117;41.2605;40.5411;42.1581
573027;125;68;57;43.7480;41.7206;46.1667
574198;520;259;261;41.1712;41.1680;41.1743
575682;1659;810;849;38.8538;38.3198;39.3634
553719;748;382;366;37.9171;37.8665;37.9699
575704;1917;971;946;39.1401;38.1056;40.2019
575712;429;222;207;39.4814;37.1622;41.9686
575721;671;365;306;41.9128;40.2918;43.8464
575739;760;395;365;37.6026;37.3532;37.8726
572934;251;133;118;39.5677;39.1917;39.9915
575755;221;105;116;42.6041;41.6810;43.4397
575763;325;159;166;41.3862;40.3365;42.3916
575771;482;247;235;39.3237;39.6862;38.9426
575780;261;130;131;40.5920;40.3154;40.8664
575810;168;90;78;47.0000;45.8222;48.3590
530794;229;109;120;42.3428;40.9312;43.6250
575828;218;113;105;43.3945;43.7566;43.0048
572985;250;124;126;36.5280;37.4516;35.6190
575844;287;141;146;41.6359;41.5922;41.6781
575879;359;205;154;43.0850;41.8171;44.7727
575887;279;143;136;39.6613;37.4231;42.0147
575909;218;105;113;39.7477;40.5286;39.0221
572888;216;104;112;36.8287;39.2115;34.6161
575917;64;36;28;54.1875;50.1944;59.3214
575925;491;250;241;43.2576;42.2640;44.2884
575933;131;72;59;40.9504;39.2361;43.0424
575941;484;233;251;40.6860;41.1695;40.2371
575968;362;182;180;43.4365;42.4505;44.4333
575984;320;149;171;42.7563;42.7752;42.7398
575992;369;177;192;43.4566;41.6695;45.1042
576000;427;207;220;42.4602;42.8188;42.1227
576018;262;129;133;41.8702;40.9806;42.7331
576026;637;325;312;40.6758;38.7954;42.6346
576042;122;69;53;49.1885;48.5870;49.9717
576051;988;483;505;40.7844;40.2288;41.3158
572560;320;157;163;43.0594;42.6083;43.4939
572586;501;243;258;43.7355;41.9033;45.4612
505391;355;186;169;46.2183;43.1828;49.5592
577774;378;171;207;39.1190;39.6170;38.7077
574309;188;99;89;47.8298;46.8838;48.8820
572519;476;242;234;41.1576;40.6942;41.6368
577812;144;80;64;48.8819;47.3375;50.8125
577821;117;61;56;45.2179;41.4508;49.3214
577839;1011;494;517;40.2201;39.2409;41.1557
572632;175;92;83;41.5171;39.8913;43.3193
577863;1259;619;640;46.1577;44.2964;47.9578
577871;329;168;161;46.3298;45.4881;47.2081
572250;125;62;63;42.8040;41.8387;43.7540
577898;142;73;69;44.8521;43.1849;46.6159
505145;1644;807;837;40.3066;38.6896;41.8656
577910;448;239;209;43.7076;44.1025;43.2560
577928;1515;755;760;44.1983;42.5437;45.8421
577936;882;435;447;40.9444;42.0356;39.8826
577944;981;484;497;40.3726;38.9669;41.7414
572357;355;187;168;40.3817;39.6016;41.2500
577961;334;175;159;40.7156;40.7286;40.7013
572683;190;94;96;44.5684;43.7447;45.3750
577987;564;289;275;40.2429;38.8599;41.6964
577995;1967;964;1003;42.0140;40.9627;43.0244
574325;224;114;110;38.0313;36.7105;39.4000
572284;52;34;18;45.4423;42.4118;51.1667
578037;287;150;137;42.5314;42.0267;43.0839
578053;130;65;65;37.5923;38.1615;37.0231
572365;402;202;200;43.1318;41.6832;44.5950
572691;1706;875;831;42.2984;41.4829;43.1570
572730;192;96;96;40.9375;41.8958;39.9792
578096;845;421;424;43.0124;41.9228;44.0943
578100;124;60;64;41.4919;35.0667;47.5156
578118;139;69;70;41.2338;40.6739;41.7857
578126;206;104;102;46.8932;46.7115;47.0784
578134;988;473;515;39.9929;39.2209;40.7019
578142;61;32;29;46.5984;51.2813;41.4310
578151;1174;611;563;44.5997;42.0728;47.3419
578169;187;101;86;38.0294;36.3614;39.9884
572713;414;196;218;40.5700;41.5408;39.6972
578185;1020;503;517;42.2775;40.4682;44.0377
578193;2801;1363;1438;42.5332;41.2770;43.7239
578207;543;277;266;40.9309;40.6227;41.2519
578215;327;160;167;42.0505;42.0875;42.0150
572748;406;203;203;42.5961;41.6773;43.5148
578231;717;359;358;40.9128;39.3858;42.4441
578258;816;413;403;41.5221;40.9964;42.0608
578266;147;75;72;38.9218;39.3533;38.4722
578274;405;221;184;42.2111;40.3688;44.4239
572594;86;38;48;42.6860;43.3421;42.1667
578282;1389;706;683;39.9586;39.2096;40.7328
578291;425;225;200;37.5612;35.3800;40.0150
578304;115;70;45;48.1870;46.0429;51.5222
578339;619;316;303;42.5937;40.2215;45.0677
578347;10378;5081;5297;43.4484;42.0749;44.7660
578355;947;484;463;43.8537;42.1157;45.6706
578363;320;160;160;41.1063;39.9875;42.2250
578371;99;58;41;42.4192;41.6379;43.5244
578380;1413;728;685;43.4901;42.7198;44.3088
578398;244;116;128;38.4426;39.4224;37.5547
578401;436;220;216;41.7248;41.1455;42.3148
578428;728;376;352;41.4190;40.1729;42.7500
578444;9948;4803;5145;44.7364;42.7463;46.5943
578452;208;113;95;48.3990;47.1549;49.8789
580694;1022;523;499;39.4481;39.2361;39.6703
572608;225;110;115;42.1089;43.7182;40.5696
572438;69;37;32;40.0072;42.8243;36.7500
578479;655;343;312;42.8511;42.1414;43.6314
578487;1174;600;574;41.4787;41.6333;41.3171
572721;700;355;345;40.4543;40.1901;40.7261
578509;1015;512;503;41.9818;41.5000;42.4722
578550;303;160;143;44.3515;44.4625;44.2273
578576;8813;4271;4542;43.3313;41.4822;45.0700
578584;1249;633;616;40.0949;39.0008;41.2192
572373;509;276;233;38.1012;37.2355;39.1266
578622;167;77;90;40.5060;39.6558;41.2333
578631;324;165;159;42.9167;43.4879;42.3239
578649;148;70;78;45.6014;44.9286;46.2051
578657;1144;567;577;42.1250;41.6076;42.6334
574333;116;59;57;43.4138;44.6186;42.1667
578673;634;307;327;46.4842;43.8746;48.9343
578681;318;166;152;43.9245;43.2470;44.6645
578690;238;114;124;43.8613;44.1140;43.6290
578703;159;82;77;41.8208;40.3902;43.3442
578711;619;326;293;41.2447;38.6503;44.1314
572233;64;33;31;47.1094;45.9848;48.3065
578720;543;262;281;39.4632;38.8779;40.0089
578738;997;510;487;39.4940;39.0765;39.9312
578746;238;120;118;40.6471;41.4083;39.8729
578754;233;117;116;43.0837;40.8248;45.3621
578762;165;84;81;40.3606;39.8333;40.9074
580325;1710;835;875;42.7942;41.4856;44.0429
578789;1027;533;494;40.4309;39.8790;41.0263
578801;266;138;128;39.9211;38.0507;41.9375
578819;246;121;125;39.5041;37.6653;41.2840
578835;83;44;39;42.8133;41.7955;43.9615
577731;16758;7992;8766;42.9620;41.2785;44.4968
578843;368;179;189;45.8859;44.9916;46.7328
578851;408;219;189;39.2868;36.4863;42.5317
578860;111;55;56;46.6982;42.0091;51.3036
578878;438;236;202;39.8470;39.4873;40.2673
578886;432;214;218;42.9375;41.7991;44.0550
578894;530;287;243;40.6981;38.1690;43.6852
572616;156;86;70;44.6410;41.8605;48.0571
578908;905;455;450;42.1166;40.1330;44.1222
578916;111;54;57;38.3919;37.3333;39.3947
572624;336;171;165;35.2530;34.4181;36.1182
578932;956;490;466;40.2406;40.4286;40.0429
578941;299;147;152;39.6271;39.4932;39.7566
578959;161;82;79;42.3509;42.7439;41.9430
578967;424;219;205;41.5259;39.2580;43.9488
581127;101;56;45;39.6980;40.6071;38.5667
578975;447;227;220;42.0056;40.3987;43.6636
572292;68;40;28;45.5588;45.3250;45.8929
578991;41;22;19;40.9634;44.3182;37.0789
572195;42;23;19;43.0476;41.6304;44.7632
547981;455;231;224;43.7242;42.3831;45.1071
573426;173;73;100;44.9740;35.4315;51.9400
553760;440;222;218;40.9614;42.1622;39.7385
548006;97;47;50;40.2732;40.8191;39.7600
579947;1316;642;674;45.0182;42.6075;47.3145
579963;263;127;136;38.6863;39.3504;38.0662
579971;1166;580;586;39.8062;39.1672;40.4386
579980;395;205;190;40.8139;38.6317;43.1684
579998;184;92;92;44.0000;43.9457;44.0543
580015;3005;1441;1564;42.2371;40.6742;43.6771
580023;398;205;193;40.6231;41.5244;39.6658
580031;15384;7496;7888;43.7287;42.1748;45.2054
580040;582;289;293;40.9828;39.2439;42.6980
580058;645;326;319;39.5217;38.7423;40.3182
580066;162;87;75;42.6605;45.5345;39.3267
580074;703;358;345;40.3620;39.8575;40.8855
548014;1321;646;675;40.9421;39.7817;42.0526
548031;838;414;424;39.3210;38.1473;40.4670
580091;544;263;281;39.0202;38.8460;39.1833
580112;1329;647;682;40.7754;39.3485;42.1290
580121;2598;1346;1252;40.6390;38.9829;42.4193
580163;407;226;181;38.7506;38.6195;38.9144
580210;364;186;178;39.9121;40.6882;39.1011
580228;201;98;103;43.1318;44.4694;41.8592
548049;498;249;249;40.9478;40.8976;40.9980
580261;825;396;429;42.2515;43.4394;41.1550
580279;1010;515;495;41.9149;41.0806;42.7828
580295;463;232;231;44.0097;42.0862;45.9416
580333;631;320;311;40.8962;39.8781;41.9437
547972;107;61;46;39.2196;39.5328;38.8043
580341;375;197;178;41.6147;40.2208;43.1573
580350;8648;4250;4398;44.1383;42.4311;45.7881
580376;3149;1533;1616;42.9951;41.5378;44.3775
580392;698;360;338;41.9413;41.8806;42.0059
580406;250;136;114;44.5400;43.4485;45.8421
580414;336;163;173;39.8839;40.5736;39.2341
580422;321;156;165;42.3567;41.0513;43.5909
580431;899;475;424;41.8270;40.7716;43.0094
580465;356;185;171;41.2079;41.4676;40.9269
574449;178;89;89;37.6348;39.8820;35.3876
580481;4205;2118;2087;44.0099;42.6756;45.3639
580490;320;156;164;42.3500;41.8077;42.8659
580503;944;464;480;43.2267;43.6013;42.8646
580511;9906;4736;5170;43.9423;42.3763;45.3768
571695;312;159;153;41.6827;42.5377;40.7941
580538;6406;3162;3244;42.0041;40.7043;43.2710
580562;170;93;77;44.7706;43.3710;46.4610
580147;1759;894;865;40.1623;39.0548;41.3069
580571;529;275;254;41.1805;40.7618;41.6339
580589;755;392;363;42.8285;42.2168;43.4890
580619;362;185;177;38.3039;37.9432;38.6808
580627;1147;571;576;40.4625;40.1375;40.7847
580635;742;387;355;40.3127;38.7016;42.0690
580643;601;322;279;39.9143;38.5745;41.4606
580651;530;273;257;41.0566;41.1630;40.9436
580660;251;130;121;38.7988;37.7538;39.9215
580678;136;69;67;43.9853;43.9638;44.0075
580686;948;489;459;40.4789;38.4366;42.6547
571920;305;166;139;41.9721;40.4398;43.8022
580716;693;345;348;39.0873;39.1609;39.0144
580724;282;144;138;40.5780;39.9375;41.2464
580732;692;375;317;37.8887;37.0813;38.8438
580741;253;124;129;38.5356;36.1855;40.7946
580759;364;182;182;43.0247;42.0989;43.9505
580767;250;123;127;40.2160;40.1911;40.2402
580775;580;295;285;37.5621;35.8797;39.3035
580783;66;37;29;47.1212;45.0946;49.7069
580805;279;143;136;41.3925;40.7657;42.0515
580821;339;168;171;41.0015;42.1429;39.8801
580830;60;33;27;48.9333;51.7121;45.5370
575542;170;88;82;45.8000;46.3977;45.1585
580848;1933;952;981;38.1301;37.0914;39.1381
547905;829;412;417;40.4867;39.7597;41.2050
572209;378;201;177;42.7593;41.9627;43.6638
580872;702;342;360;42.7051;42.2661;43.1222
580881;289;141;148;43.4862;44.1667;42.8378
574392;569;292;277;40.8849;39.7705;42.0596
580902;156;81;75;42.9679;41.6111;44.4333
555240;620;309;311;39.5161;39.3091;39.7219
580929;413;213;200;40.6574;39.3826;42.0150
580945;452;217;235;39.7058;39.9931;39.4404
547964;239;125;114;42.5167;41.7080;43.4035
580961;931;481;450;42.5172;41.0904;44.0422
580970;581;302;279;42.3072;40.5331;44.2276
572306;187;101;86;45.0989;41.4901;49.3372
580988;106;57;49;41.7736;38.9561;45.0510
580996;185;93;92;41.1162;40.4140;41.8261
581003;135;73;62;39.5444;37.1712;42.3387
581011;186;89;97;41.0269;40.3989;41.6031
580708;290;146;144;45.1483;44.8630;45.4375
581038;205;106;99;40.1976;37.5000;43.0859
581046;866;450;416;40.9400;39.1711;42.8534
581054;579;303;276;45.3670;44.8333;45.9529
581062;571;281;290;42.0166;41.7278;42.2966
547921;85;41;44;37.5706;37.2317;37.8864
581071;797;419;378;41.1801;40.4952;41.9392
575861;171;86;85;42.0614;41.6395;42.4882
581089;326;157;169;41.1258;39.0350;43.0680
579891;14280;7019;7261;43.9176;41.7650;45.9984
581101;298;166;132;42.5738;40.0241;45.7803
581119;754;373;381;38.6127;37.3016;39.8963
572489;126;63;63;43.5476;42.0079;45.0873
581143;338;172;166;42.0503;40.3198;43.8434
581151;778;397;381;41.2506;40.3539;42.1850
548022;171;94;77;42.7515;42.5532;42.9935
581178;952;476;476;41.4076;40.4391;42.3761
581186;12288;6103;6185;42.4980;40.4513;44.5176
581194;91;53;38;45.1593;42.9906;48.1842
581208;768;390;378;42.3398;41.3051;43.4074
581216;238;122;116;41.9664;38.6885;45.4138
581224;737;375;362;42.6465;42.6760;42.6160
581232;215;101;114;37.8953;36.0644;39.5175
581259;6077;2990;3087;42.4863;40.4893;44.4206
581267;299;174;125;41.5201;43.7586;38.4040
581275;1014;508;506;38.6055;38.8543;38.3557
546194;122;60;62;44.4426;43.9000;44.9677
548260;158;90;68;44.5443;41.9556;47.9706
573566;218;118;100;48.3119;48.8390;47.6900
548430;241;126;115;47.2137;44.3492;50.3522
568457;287;153;134;41.6359;42.2059;40.9851
573558;78;36;42;39.4103;41.3333;37.7619
568465;122;62;60;43.7459;46.0968;41.3167
548278;151;72;79;43.5000;41.1111;45.6772
568490;169;89;80;43.9497;43.2978;44.6750
548375;82;35;47;46.5000;47.7857;45.5426
568503;1070;544;526;40.2019;38.9779;41.4677
568520;340;181;159;43.1824;43.2017;43.1604
568538;460;221;239;40.0043;40.1923;39.8305
568597;423;215;208;39.9208;38.5140;41.3750
568601;912;457;455;43.5384;42.6904;44.3901
548448;85;37;48;41.4412;41.2568;41.5833
568619;164;77;87;39.3415;38.8636;39.7644
568635;2680;1318;1362;42.6679;41.1510;44.1358
568651;1333;678;655;42.3740;42.4218;42.3244
568660;972;504;468;42.0216;41.1825;42.9252
568414;23442;11454;11988;43.5570;41.6404;45.3883
568678;1095;545;550;43.6288;43.3991;43.8564
548596;49;27;22;51.9898;53.2778;50.4091
568694;592;300;292;41.9679;41.0100;42.9521
568708;581;300;281;37.1919;36.1633;38.2900
548243;69;38;31;50.3696;44.1053;58.0484
568724;242;127;115;44.1570;43.3031;45.1000
530646;241;128;113;43.1183;41.5391;44.9071
568759;9178;4517;4661;43.5659;42.1509;44.9372
568767;108;55;53;47.0463;46.0818;48.0472
573574;152;80;72;49.0066;49.8875;48.0278
568783;82;41;41;41.0610;43.6707;38.4512
568805;273;140;133;46.3425;46.6643;46.0038
548413;129;67;62;41.9884;44.3806;39.4032
546216;236;119;117;39.6864;39.8782;39.4915
568821;382;192;190;44.0262;41.8490;46.2263
568848;267;134;133;40.7434;38.7985;42.7030
568856;123;62;61;45.3374;41.4194;49.3197
548286;445;222;223;39.6483;40.2568;39.0426
548529;175;79;96;35.4657;32.1456;38.1979
568881;155;74;81;45.1065;46.5135;43.8210
548189;196;100;96;43.3265;42.0900;44.6146
568899;223;108;115;42.8946;41.1852;44.5000
568902;803;418;385;42.5262;40.9904;44.1935
548618;98;53;45;48.1531;45.3679;51.4333
568929;519;267;252;43.8622;43.4251;44.3254
568937;134;69;65;45.7313;43.5580;48.0385
568945;1598;822;776;42.6915;41.8723;43.5593
548570;110;60;50;44.1909;39.9833;49.2400
568953;235;124;111;44.1553;42.0887;46.4640
548308;150;87;63;40.8800;38.8218;43.7222
568970;95;46;49;41.1316;42.2826;40.0510
548481;54;29;25;47.5556;44.3621;51.2600
568988;5043;2451;2592;46.4681;45.0255;47.8322
568996;79;39;40;43.2342;41.1410;45.2750
569011;566;287;279;44.0989;42.7334;45.5036
569020;870;426;444;43.5414;43.2746;43.7973
569038;1184;592;592;40.8590;40.7804;40.9375
569046;654;349;305;44.1162;42.0244;46.5098
569062;640;332;308;42.1203;39.4337;45.0162
569071;205;103;102;44.6659;43.3252;46.0196
569089;647;323;324;46.2388;44.8622;47.6111
548316;215;110;105;37.7186;37.0182;38.4524
569127;159;81;78;40.7642;42.4877;38.9744
548197;76;35;41;46.1316;47.2143;45.2073
569160;551;277;274;43.0191;43.1173;42.9197
569151;123;57;66;42.5732;43.7807;41.5303
555266;558;283;275;38.6828;39.0124;38.3436
569186;1382;685;697;40.8813;40.1540;41.5961
548588;261;127;134;37.8333;38.1535;37.5299
569208;184;96;88;37.9130;37.0417;38.8636
569216;375;186;189;37.8493;38.4355;37.2725
548359;161;83;78;37.5559;37.6325;37.4744
569224;377;192;185;39.4045;39.2500;39.5649
569232;168;86;82;44.7262;42.5349;47.0244
569241;138;74;64;36.7101;35.2027;38.4531
548634;136;75;61;44.5735;43.5533;45.8279
548251;133;64;69;51.8083;49.5000;53.9493
569291;742;372;370;43.9744;41.8978;46.0622
573591;70;33;37;48.8286;46.7727;50.6622
569313;137;65;72;41.1642;42.0846;40.3333
569321;3991;2000;1991;41.7175;40.1585;43.2835
569348;421;212;209;40.3622;39.3302;41.4091
569364;163;88;75;38.6043;37.4773;39.9267
569399;504;260;244;42.7024;41.9962;43.4549
569402;178;97;81;46.7865;44.8814;49.0679
569411;61;31;30;53.3525;52.2097;54.5333
569429;334;173;161;42.8772;41.2225;44.6553
548421;287;145;142;40.9286;40.6586;41.2042
548324;87;42;45;43.0517;40.0952;45.8111
569461;188;92;96;42.7394;41.6304;43.8021
569470;279;139;140;39.6326;36.3633;42.8786
548553;122;70;52;39.8279;37.6571;42.7500
569488;296;160;136;47.1115;44.5875;50.0809
548341;60;31;29;39.3500;40.3710;38.2586
548499;38;19;19;49.4211;38.2895;60.5526
573604;160;77;83;45.3188;43.7208;46.8012
569518;734;379;355;41.4823;41.9723;40.9592
569534;251;128;123;40.4084;38.5156;42.3780
569569;6490;3191;3299;44.8026;43.5548;46.0095
569585;812;405;407;42.2143;41.0062;43.4165
569593;1968;983;985;39.4106;38.4298;40.3893
569615;392;192;200;40.5383;40.1302;40.9300
569623;176;92;84;39.4602;37.4891;41.6190
569640;498;251;247;44.3233;40.4880;48.2206
548537;47;25;22;40.2234;40.7800;39.5909
569658;673;330;343;45.0067;42.9909;46.9461
569674;323;137;186;44.2709;45.8139;43.1344
569682;564;284;280;42.3901;41.9085;42.8786
569691;816;413;403;44.7512;44.6985;44.8052
569704;421;205;216;42.8729;42.8659;42.8796
569712;1006;493;513;46.0109;44.7901;47.1842
569721;263;127;136;39.7890;40.8307;38.8162
573582;184;99;85;41.9565;41.0455;43.0176
569739;48;26;22;44.3958;44.7308;44.0000
530654;241;119;122;37.3465;37.5840;37.1148
548626;73;31;42;43.7603;41.1129;45.7143
530662;146;69;77;40.3288;40.9203;39.7987
569780;3112;1512;1600;42.5958;41.4319;43.6956
569801;376;184;192;43.8484;42.8424;44.8125
586854;174;88;86;40.2011;42.2273;38.1279
586862;2362;1189;1173;42.5381;40.6573;44.4446
586889;288;144;144;38.7569;39.2569;38.2569
586897;421;207;214;42.9941;43.1908;42.8037
586901;139;73;66;43.2986;39.0479;48.0000
587184;83;40;43;43.5723;40.1750;46.7326
586927;170;81;89;39.1294;38.3148;39.8708
586943;3766;1917;1849;42.2685;40.4212;44.1836
590371;104;48;56;43.5577;42.2500;44.6786
586951;289;146;143;37.9256;38.4315;37.4091
586978;501;249;252;42.1547;43.0542;41.2659
586986;170;81;89;39.3882;41.6111;37.3652
587001;120;63;57;45.4583;42.7063;48.5000
587117;291;145;146;41.2663;43.7483;38.8014
587010;374;191;183;40.7861;40.2277;41.3689
587028;1860;937;923;40.0280;39.1009;40.9691
587036;292;141;151;36.2295;37.6418;34.9106
587044;1277;661;616;41.1586;40.5696;41.7906
587061;103;51;52;39.4806;40.3235;38.6538
587079;95;47;48;41.9737;39.6064;44.2917
587087;188;103;85;40.6064;38.0825;43.6647
587095;478;250;228;39.3013;39.0840;39.5395
506729;195;96;99;45.6692;44.5521;46.7525
587109;134;71;63;42.3507;39.9507;45.0556
587125;174;93;81;45.3448;43.8011;47.1173
587141;752;366;386;43.4960;42.8825;44.0777
587150;149;74;75;47.3658;44.5676;50.1267
587168;606;316;290;44.3564;42.6487;46.2172
587206;95;50;45;35.0684;34.4800;35.7222
587192;133;71;62;40.8759;38.1620;43.9839
590681;104;51;53;39.5481;38.5980;40.4623
587222;141;74;67;44.0816;44.1351;44.0224
550281;456;236;220;42.3355;41.6780;43.0409
587249;579;294;285;41.8921;39.7245;44.1281
587265;187;96;91;42.8476;41.2917;44.4890
587273;242;125;117;43.8843;42.8440;44.9957
587281;125;70;55;42.8680;42.5000;43.3364
586846;51216;25140;26076;42.8410;41.3253;44.3022
587290;206;107;99;45.3155;43.9953;46.7424
587303;99;58;41;41.5808;40.6724;42.8659
587320;129;65;64;42.7946;43.3923;42.1875
587338;157;79;78;49.3344;50.3228;48.3333
587346;1950;1023;927;40.6297;38.9721;42.4590
587362;190;93;97;43.5316;41.5108;45.4691
587371;74;36;38;46.3649;47.8056;45.0000
590843;1362;706;656;41.3789;40.3442;42.4924
587389;193;94;99;43.7228;41.2766;46.0455
587401;908;456;452;40.6839;38.8092;42.5752
587419;67;34;33;41.7985;41.5294;42.0758
587427;478;250;228;43.5335;42.2400;44.9518
587435;610;307;303;41.3393;39.9853;42.7112
587443;197;98;99;45.6574;43.9796;47.3182
587451;93;48;45;45.2527;46.3125;44.1222
587478;2971;1502;1469;40.8696;39.4740;42.2965
587486;621;309;312;42.1055;40.9013;43.2981
587494;200;107;93;43.4550;39.4346;48.0806
587508;268;128;140;38.1903;38.3828;38.0143
587524;136;74;62;46.0882;42.7162;50.1129
587532;163;90;73;42.7883;41.4667;44.4178
587541;887;442;445;42.5598;41.1471;43.9629
587559;124;66;58;40.7661;39.7879;41.8793
587567;204;109;95;40.2941;38.9679;41.8158
587575;198;102;96;42.3586;40.3922;44.4479
587583;231;119;112;44.0887;43.6765;44.5268
587591;826;415;411;42.7736;42.4494;43.1010
587613;75;37;38;40.0200;38.1216;41.8684
587214;73;38;35;37.1986;39.7632;34.4143
587621;199;104;95;43.4146;42.4038;44.5211
587630;67;37;30;40.5000;37.8243;43.8000
587648;85;38;47;46.5588;48.6842;44.8404
587656;179;86;93;34.8520;35.3256;34.4140
587672;120;63;57;42.6167;42.9762;42.2193
587681;419;216;203;43.1993;43.2083;43.1897
587702;202;97;105;40.2624;40.6134;39.9381
587711;5150;2576;2574;41.6515;40.2395;43.0645
587745;842;441;401;41.2055;39.0578;43.5673
587761;249;130;119;42.2912;41.9077;42.7101
587176;446;236;210;37.6839;37.2161;38.2095
587788;467;236;231;40.8126;39.3517;42.3052
587796;426;204;222;41.9249;42.9804;40.9550
587800;176;96;80;41.8977;42.5938;41.0625
587818;349;187;162;40.1103;38.5695;41.8889
587826;120;57;63;39.1250;41.2193;37.2302
587834;236;124;112;44.0720;41.8306;46.5536
587851;83;39;44;43.9458;43.9872;43.9091
587877;62;32;30;44.3871;43.3750;45.4667
587885;299;148;151;40.7274;40.3851;41.0629
550299;433;213;220;39.9226;37.6643;42.1091
587915;173;88;85;39.4191;38.3409;40.5353
587923;621;328;293;42.4291;40.3720;44.7321
587931;1098;538;560;40.0656;39.0112;41.0786
587940;87;43;44;40.3391;40.7326;39.9545
587958;449;239;210;39.6648;38.2406;41.2857
587982;265;129;136;41.8698;41.2829;42.4265
587991;50;22;28;52.9200;49.8636;55.3214
588008;208;104;104;42.8942;43.3654;42.4231
547255;69;32;37;53.3841;48.9375;57.2297
588024;5273;2551;2722;44.5529;42.5027;46.4743
588032;5714;2832;2882;43.2599;41.7309;44.7623
588041;157;83;74;38.4045;37.3434;39.5946
588067;138;65;73;38.4928;37.9615;38.9658
588075;223;114;109;44.0381;42.2719;45.8853
588083;89;45;44;42.5674;41.7222;43.4318
588091;38;17;21;37.5789;34.0882;40.4048
588105;37;18;19;55.8243;53.4444;58.0789
588113;1272;652;620;42.7484;41.5322;44.0274
588121;643;324;319;40.6960;39.7284;41.6787
588130;153;79;74;40.6111;38.3987;42.9730
588148;137;74;63;39.6679;39.3514;40.0397
588156;314;162;152;40.3312;39.4630;41.2566
588164;72;33;39;37.6528;40.8333;34.9615
588172;914;455;459;40.8184;39.5176;42.1078
588181;432;223;209;39.5278;38.9843;40.1077
588199;121;51;70;41.4008;45.5196;38.4000
588202;255;131;124;40.3353;39.4389;41.2823
587231;48;22;26;42.4583;37.0455;47.0385
588211;217;103;114;43.2696;43.9757;42.6316
588229;98;49;49;33.8061;33.0510;34.5612
588245;54;31;23;43.2593;40.5645;46.8913
588253;447;224;223;39.7752;40.0313;39.5179
588261;88;46;42;40.5341;40.7174;40.3333
588270;112;63;49;43.2857;37.7063;50.4592
588288;430;193;237;42.7860;39.9974;45.0570
509388;85;40;45;41.6294;41.4750;41.7667
561118;90;50;40;39.6111;41.0000;37.8750
561126;51;26;25;40.9118;36.1154;45.9000
547549;172;84;88;46.1105;46.1548;46.0682
561240;70;37;33;44.7714;42.0676;47.8030
509418;104;58;46;40.6058;39.7759;41.6522
547581;629;317;312;42.8784;41.4211;44.3590
547603;137;74;63;48.5876;43.9054;54.0873
547638;339;174;165;41.0251;39.2989;42.8455
561312;206;106;100;44.6845;41.4057;48.1600
561801;115;61;54;44.3435;40.9098;48.2222
547662;286;153;133;48.0490;48.4150;47.6278
547689;121;61;60;47.6570;48.2869;47.0167
547719;626;310;316;42.7093;42.3258;43.0854
547735;616;329;287;39.2468;38.4179;40.1969
529826;96;48;48;42.5208;40.2708;44.7708
561142;127;54;73;41.2480;40.9444;41.4726
547760;1752;864;888;44.0885;42.5741;45.5619
547778;1006;504;502;45.1620;44.3333;45.9940
598704;128;63;65;44.6406;46.1984;43.1308
561924;116;54;62;40.5345;41.0556;40.0806
561932;205;103;102;42.8317;45.2184;40.4216
561762;98;50;48;43.0510;42.6000;43.5208
551546;78;44;34;43.7949;43.6818;43.9412
529869;59;32;27;46.3983;44.5000;48.6481
561754;65;35;30;37.5923;35.8714;39.6000
547883;103;53;50;43.5583;44.2925;42.7800
561096;74;41;33;50.1486;47.2317;53.7727
547913;1837;910;927;43.2028;42.0868;44.2983
551589;165;78;87;40.3667;40.1923;40.5230
547930;307;153;154;40.0863;39.9248;40.2468
547948;635;315;320;43.6748;42.4683;44.8625
547956;187;86;101;46.6551;48.4535;45.1238
547999;10970;5436;5534;43.9907;42.2268;45.7233
561339;33;18;15;54.4697;50.4444;59.3000
561321;97;51;46;37.5928;33.0490;42.6304
561461;41;22;19;41.5244;42.5455;40.3421
548073;64;34;30;45.4219;47.5000;43.0667
548081;935;483;452;40.7791;39.1998;42.4668
548090;353;193;160;42.0411;40.5466;43.8438
548103;266;132;134;43.8985;43.2652;44.5224
548111;3760;1883;1877;44.5402;42.8595;46.2262
548120;416;203;213;37.9231;38.8005;37.0869
548146;162;82;80;44.6235;43.6220;45.6500
598712;331;170;161;39.9079;39.1059;40.7547
548162;204;101;103;39.3824;39.1634;39.5971
548171;709;351;358;41.6072;41.8134;41.4050
561371;128;69;59;37.4922;37.0797;37.9746
548201;229;119;110;44.7271;43.3403;46.2273
548219;337;174;163;46.1231;44.1839;48.1933
548227;155;76;79;45.7710;44.6053;46.8924
548235;104;58;46;47.7500;44.2759;52.1304
562041;68;32;36;42.7647;42.1875;43.2778
561282;100;56;44;43.3500;42.9464;43.8636
598721;255;126;129;40.0451;38.1825;41.8643
561100;282;183;99;47.1809;46.7787;47.9242
561266;58;33;25;42.3966;43.5606;40.8600
548332;994;504;490;45.1046;44.2262;46.0082
561347;56;25;31;43.5000;46.3800;41.1774
548367;115;63;52;46.7261;45.3730;48.3654
529834;160;85;75;38.6250;36.9000;40.5800
548383;262;126;136;43.3321;44.1905;42.5368
548391;374;186;188;43.7353;42.7097;44.7500
548405;198;100;98;43.4192;41.2100;45.6735
561819;123;58;65;41.8333;38.6897;44.6385
561177;111;55;56;41.3649;40.6818;42.0357
548456;1120;563;557;44.3107;42.5764;46.0637
548464;996;516;480;43.0331;40.8275;45.4042
548472;795;393;402;44.2899;42.8995;45.6493
561967;564;280;284;42.7465;41.0607;44.4085
537691;155;87;68;42.1645;40.5000;44.2941
548502;226;105;121;47.9867;44.5571;50.9628
548511;4717;2303;2414;44.9323;43.3684;46.4242
561916;134;64;70;42.4328;43.3281;41.6143
547492;16048;7815;8233;43.9821;42.5751;45.3177
548545;75;34;41;41.8067;45.2941;38.9146
548561;2531;1243;1288;44.2756;42.8596;45.6421
561436;99;51;48;36.7525;35.4412;38.1458
548600;247;127;120;45.7510;42.4449;49.2500
537829;71;36;35;50.4437;48.2222;52.7286
561941;83;45;38;42.1265;43.7000;40.2632
598755;276;144;132;42.2319;40.5139;44.1061
561789;227;118;109;41.4559;40.6441;42.3349
561274;53;29;24;45.1981;35.7759;56.5833
562009;624;323;301;39.5785;38.4040;40.8389
548715;141;73;68;45.8262;44.5000;47.2500
548731;129;63;66;43.0581;42.5000;43.5909
548740;158;78;80;42.4747;40.8333;44.0750
548766;136;72;64;48.9706;45.4306;52.9531
548774;768;373;395;41.2096;41.5295;40.9076
561843;70;33;37;41.0714;42.1970;40.0676
561452;113;53;60;42.4912;42.7075;42.3000
537594;110;58;52;47.4909;48.3103;46.5769
561487;67;35;32;44.9030;45.1286;44.6563
598763;120;61;59;42.4250;43.5984;41.2119
598771;52;29;23;42.9423;40.6379;45.8478
561355;80;44;36;48.3625;45.2273;52.1944
548936;399;202;197;48.2268;47.5594;48.9112
537608;255;130;125;38.9510;38.1308;39.8040
548987;61;32;29;48.1230;43.3125;53.4310
562033;103;48;55;44.0049;40.1875;47.3364
537730;71;40;31;46.0493;39.3500;54.6935
549002;233;123;110;43.7618;41.9146;45.8273
549011;281;147;134;45.0979;44.5952;45.6493
549045;198;96;102;42.3687;41.9375;42.7745
549053;223;102;121;45.2937;46.4608;44.3099
549061;130;68;62;41.0615;36.8382;45.6935
549126;92;48;44;52.8587;50.1458;55.8182
599239;182;94;88;37.2198;35.5638;38.9886
549134;150;80;70;49.5467;48.2000;51.0857
549142;710;346;364;41.8408;41.5434;42.1236
561771;15;8;7;67.1667;65.2500;69.3571
561797;284;140;144;41.2993;41.7786;40.8333
549177;246;126;120;44.1707;42.5238;45.9000
561975;228;112;116;42.9386;42.1964;43.6552
561363;99;54;45;51.1667;49.2963;53.4111
598666;45;20;25;40.6111;42.5500;39.0600
549215;1149;580;569;43.6706;42.6000;44.7619
561908;84;41;43;39.2262;42.4756;36.1279
549231;2944;1476;1468;44.7979;43.1213;46.4837
590274;194;97;97;45.5052;45.7784;45.2320
590282;190;82;108;45.4368;45.4390;45.4352
544833;96;52;44;46.1771;44.4808;48.1818
590304;191;95;96;40.6623;40.7526;40.5729
590312;256;132;124;45.7773;44.6288;47.0000
590321;360;191;169;44.7667;43.4058;46.3047
550400;134;65;69;42.4030;41.0538;43.6739
590347;153;79;74;48.5719;46.3101;50.9865
590363;225;113;112;48.3756;48.9779;47.7679
590380;689;348;341;43.0936;41.6293;44.5880
590401;1215;604;611;41.3560;40.2666;42.4329
590410;359;175;184;39.5975;39.6657;39.5326
590428;84;48;36;49.6429;47.7083;52.2222
590436;547;274;273;44.8126;42.4526;47.1813
553964;186;99;87;43.2688;40.5202;46.3966
590444;314;148;166;39.9713;40.8108;39.2229
590452;315;165;150;42.6619;40.9000;44.6000
590461;188;101;87;44.4096;42.0545;47.1437
590479;206;96;110;40.8350;40.1146;41.4636
590487;229;122;107;48.5786;48.3115;48.8832
590495;202;100;102;47.9307;45.1900;50.6176
590509;203;102;101;40.3571;39.2941;41.4307
590517;584;304;280;42.3510;40.1283;44.7643
590525;123;62;61;40.7927;40.0806;41.5164
590533;427;216;211;42.2588;40.7824;43.7701
587664;149;75;74;42.1376;43.2867;40.9730
590550;421;209;212;40.4097;39.1172;41.6840
590568;317;163;154;43.9763;42.7822;45.2403
590576;901;451;450;39.8563;39.3381;40.3756
590584;548;288;260;43.9124;43.4063;44.4731
590592;364;191;173;42.2775;42.1073;42.4653
590614;197;98;99;44.5508;44.2653;44.8333
590622;302;159;143;44.1424;41.4182;47.1713
590631;139;67;72;40.6151;41.4851;39.8056
550612;54;25;29;46.7037;46.5800;46.8103
590649;273;132;141;44.2436;44.9621;43.5709
590657;90;39;51;41.8889;44.5000;39.8922
590665;64;31;33;50.7656;52.6935;48.9545
590673;1768;896;872;42.7698;40.8025;44.7913
550639;113;58;55;42.5973;41.7586;43.4818
590690;111;56;55;38.0946;37.9286;38.2636
590703;295;145;150;40.8356;39.9345;41.7067
590711;149;73;76;45.1644;45.9658;44.3947
550477;96;43;53;46.3750;49.4302;43.8962
590746;647;321;326;39.8864;40.2944;39.4847
590754;4136;2048;2088;42.3037;41.2017;43.3846
590762;175;92;83;43.3686;43.0978;43.6687
590789;4014;1952;2062;43.4532;41.8478;44.9728
590797;243;121;122;42.0679;40.6818;43.4426
550591;76;38;38;40.3684;39.6579;41.0789
590801;212;103;109;44.2075;44.1505;44.2615
590819;123;65;58;44.1911;39.9923;48.8966
590827;202;101;101;44.9455;43.8366;46.0545
590835;169;86;83;45.6775;45.5814;45.7771
590851;273;128;145;51.3681;45.4844;56.5621
510645;87;47;40;41.4540;40.9255;42.0750
590860;439;227;212;46.0558;44.7643;47.4387
590878;116;59;57;44.7672;42.1441;47.4825
590886;505;258;247;41.9396;39.8295;44.1437
590894;193;92;101;42.8782;39.8152;45.6683
590908;391;193;198;42.8734;42.2927;43.4394
590916;140;74;66;40.5286;37.0541;44.4242
545309;436;215;221;41.8119;41.7372;41.8846
550710;282;141;141;42.8972;42.8759;42.9184
590941;1015;523;492;42.1700;41.0621;43.3476
590959;117;59;58;42.0556;38.0424;46.1379
590967;180;90;90;46.2111;43.9556;48.4667
590975;210;109;101;41.0524;40.7752;41.3515
550302;146;78;68;46.9041;42.9872;51.3971
510556;284;142;142;43.1690;42.3099;44.0282
590983;91;57;34;42.8956;38.7632;49.8235
590991;104;55;49;43.5192;41.0636;46.2755
591009;494;263;231;42.9190;40.5875;45.5736
573485;80;45;35;47.1875;41.5667;54.4143
591025;165;81;84;42.1545;41.2901;42.9881
544876;144;81;63;42.2083;37.1173;48.7540
591041;393;194;199;41.3957;38.9794;43.7513
550507;561;288;273;41.0668;40.2257;41.9542
591068;127;62;65;48.7992;47.2742;50.2538
587605;126;64;62;45.1270;46.5625;43.6452
591092;106;54;52;42.7830;41.3519;44.2692
544957;62;29;33;38.9839;38.1552;39.7121
550566;396;198;198;41.0101;41.1313;40.8889
591114;276;142;134;40.5181;39.7324;41.3507
550388;255;142;113;42.8255;39.4577;47.0575
591122;237;119;118;45.4705;43.2647;47.6949
545031;129;65;64;42.3062;42.5923;42.0156
591149;91;48;43;41.6429;37.3333;46.4535
591157;223;108;115;41.4776;41.6019;41.3609
591165;406;195;211;41.0468;40.3308;41.7085
591173;1342;664;678;45.7593;43.8946;47.5855
591181;7300;3582;3718;44.2492;42.4492;45.9833
591190;736;352;384;42.7201;39.5824;45.5964
550779;167;85;82;44.9491;46.6529;43.1829
591211;4861;2406;2455;43.8051;41.7436;45.8255
591220;353;176;177;43.6756;43.0284;44.3192
591238;51;28;23;55.6765;52.9643;58.9783
591246;247;126;121;39.3219;38.0714;40.6240
591254;921;470;451;43.9680;43.5596;44.3936
591262;100;52;48;44.2500;41.7308;46.9792
510980;331;151;180;43.1133;43.2417;43.0056
591289;98;48;50;44.5408;42.1667;46.8200
591297;115;57;58;48.4304;47.6053;49.2414
546933;188;98;90;42.4415;40.9898;44.0222
591301;2046;1028;1018;44.1652;42.4630;45.8841
591319;755;373;382;44.1583;44.3660;43.9555
591327;179;96;83;42.6061;42.7083;42.4880
591335;145;72;73;42.9483;43.3472;42.5548
550469;162;91;71;42.6605;42.2363;43.2042
591360;421;199;222;42.2625;41.8819;42.6036
591378;130;66;64;40.6923;38.9242;42.5156
550370;112;57;55;43.5714;40.9211;46.3182
591394;340;175;165;44.3235;42.6771;46.0697
591408;72;37;35;49.6389;43.2297;56.4143
591416;156;81;75;44.5064;39.3148;50.1133
591424;72;34;38;38.4861;40.2353;36.9211
591432;685;331;354;43.2796;41.6057;44.8446
591441;136;69;67;45.8750;44.3986;47.3955
591459;800;390;410;43.2100;42.2128;44.1585
544752;255;131;124;46.6294;42.9580;50.5081
591491;167;85;82;44.5838;43.8647;45.3293
591505;462;230;232;41.6385;42.3348;40.9483
511307;118;59;59;42.8983;38.6356;47.1610
591521;87;44;43;38.2816;35.0000;41.6395
550493;151;78;73;41.9901;37.3846;46.9110
591548;337;169;168;41.1024;40.1864;42.0238
591556;82;40;42;44.5122;47.6000;41.5714
591564;171;87;84;45.5468;47.6609;43.3571
545040;114;57;57;50.7982;47.4649;54.1316
591581;546;279;267;40.7564;40.6505;40.8670
591602;114;57;57;49.3947;46.1140;52.6754
591611;837;427;410;43.0723;42.4602;43.7098
591629;1163;568;595;42.1328;40.7148;43.4866
591637;708;354;354;40.1963;38.7910;41.6017
591645;419;204;215;43.6981;43.0980;44.2674
511081;246;121;125;42.0528;41.7727;42.3240
591688;236;117;119;45.1314;46.6282;43.6597
591700;279;145;134;41.7545;39.8862;43.7761
545180;199;101;98;43.1281;41.1733;45.1429
591726;259;137;122;44.0907;42.5073;45.8689
591742;1661;817;844;42.1803;41.9027;42.4491
587460;130;66;64;43.7308;40.8485;46.7031
554871;543;280;263;42.4761;41.1821;43.8536
591769;592;311;281;39.9324;37.9148;42.1655
591777;133;63;70;44.0489;42.7540;45.2143
591785;355;181;174;43.3085;41.6105;45.0747
591793;262;141;121;43.9924;43.3440;44.7479
591807;475;240;235;42.1821;40.7833;43.6106
591815;299;154;145;43.9214;41.2273;46.7828
591823;113;58;55;39.9336;38.6552;41.2818
591840;729;363;366;39.5274;39.3402;39.7131
591858;430;225;205;42.5651;42.3267;42.8268
591866;454;221;233;41.4648;40.6584;42.2296
590266;35451;17283;18168;43.5514;41.9506;45.0743
550311;92;47;45;43.8804;42.5638;45.2556
587699;110;50;60;43.2818;43.8400;42.8167
591874;807;388;419;38.4244;37.7165;39.0800
588342;194;104;90;40.6856;39.0096;42.6222
511242;398;199;199;41.5955;41.2186;41.9724
591904;1152;595;557;44.3342;43.1269;45.6239
591912;153;74;79;38.4085;40.2568;36.6772
591939;868;450;418;40.8203;40.0356;41.6651
591947;143;79;64;43.5769;43.7025;43.4219
591955;119;65;54;47.9874;46.2077;50.1296
591963;122;64;58;46.6885;46.6094;46.7759
591980;228;111;117;41.2193;42.9865;39.5427
591998;1528;779;749;42.3763;40.8697;43.9433
595217;119;61;58;44.2395;41.9754;46.6207
595241;284;137;147;43.2606;41.6314;44.7789
595250;339;161;178;42.9867;43.5994;42.4326
595268;892;455;437;41.8576;41.5945;42.1316
595276;243;129;114;44.9156;41.8566;48.3772
595284;281;151;130;44.5747;43.5331;45.7846
595292;1150;596;554;40.1635;39.9899;40.3502
595306;266;135;131;40.1353;40.3148;39.9504
595322;190;83;107;42.8316;43.5241;42.2944
595641;779;380;399;42.2535;41.6947;42.7857
595349;149;78;71;39.3591;38.0641;40.7817
595357;186;92;94;44.4677;44.6522;44.2872
595365;287;154;133;37.9704;36.1104;40.1241
595381;163;92;71;45.7393;44.2935;47.6127
595390;186;92;94;42.9731;41.6739;44.2447
595403;194;98;96;39.1289;35.2857;43.0521
595411;8004;3958;4046;43.7819;42.2127;45.3169
595420;177;89;88;43.1328;42.5899;43.6818
588016;106;57;49;38.9811;40.6053;37.0918
595438;296;162;134;43.2770;40.8827;46.1716
595454;640;331;309;44.0234;42.6662;45.4773
595462;150;69;81;40.2800;40.2536;40.3025
595471;259;126;133;39.1062;40.0635;38.1992
595489;380;190;190;39.0158;38.3474;39.6842
595501;512;245;267;40.7285;39.9163;41.4738
595519;147;72;75;43.1327;39.9306;46.2067
595535;592;305;287;46.1959;44.1557;48.3641
595578;333;174;159;45.1186;43.5517;46.8333
595586;1616;782;834;40.6225;40.1662;41.0504
595594;1327;681;646;43.0674;40.8906;45.3622
595608;218;111;107;41.6743;39.5901;43.8364
595624;159;75;84;41.7201;41.2067;42.1786
595659;199;101;98;40.9824;39.6089;42.3980
595675;91;43;48;43.7637;47.7791;40.1667
595683;74;41;33;44.8514;41.2561;49.3182
595713;164;84;80;45.4085;43.6310;47.2750
595721;213;108;105;43.6502;41.0278;46.3476
595705;41;20;21;41.2805;38.2500;44.1667
595730;345;184;161;41.0188;38.0815;44.3758
595756;625;322;303;38.7480;38.1832;39.3482
595748;105;52;53;38.5286;40.5192;36.5755
595772;1147;563;584;45.1792;44.1661;46.1558
595802;289;148;141;43.4619;42.7703;44.1879
595811;171;84;87;40.0497;38.5714;41.4770
595829;156;85;71;41.1154;39.5118;43.0352
595845;114;60;54;38.5000;36.2167;41.0370
595853;153;80;73;41.9183;40.7000;43.2534
595861;261;144;117;44.4042;43.3125;45.7479
595870;115;57;58;44.1870;42.2018;46.1379
595888;192;98;94;43.8750;41.9694;45.8617
595896;110;53;57;38.1091;39.7453;36.5877
595900;294;138;156;40.1565;41.3768;39.0769
587842;357;185;172;38.6989;38.7865;38.6047
595918;402;196;206;44.1144;43.2143;44.9709
595926;1864;943;921;40.2339;38.9475;41.5510
595951;611;309;302;41.0385;40.4126;41.6788
595969;201;100;101;41.0622;42.2500;39.8861
595977;178;90;88;44.7135;42.8889;46.5795
596001;44;21;23;40.4091;41.7381;39.1957
596019;559;298;261;37.1977;35.6409;38.9751
596035;228;123;105;37.5132;35.4187;39.9667
596051;407;230;177;40.6400;38.9304;42.8616
596060;55;23;32;53.7909;48.5000;57.5938
596086;267;135;132;44.9270;44.0185;45.8561
596094;462;222;240;38.9091;37.5946;40.1250
596108;202;100;102;45.1683;43.3300;46.9706
596116;1981;1005;976;42.2658;40.6791;43.8996
587516;179;86;93;40.3436;40.6744;40.0376
549835;45;23;22;50.3667;48.6739;52.1364
587770;76;41;35;44.6053;42.8415;46.6714
596132;139;75;64;44.3201;41.3400;47.8125
596141;606;297;309;42.2459;38.4495;45.8948
596159;45;23;22;51.4556;45.7174;57.4545
596183;373;182;191;40.3365;38.6813;41.9136
596205;977;503;474;39.9186;38.5398;41.3819
596213;168;80;88;40.6667;40.3625;40.9432
596221;648;325;323;37.7948;37.6569;37.9334
587974;323;158;165;41.0697;39.4620;42.6091
596230;10049;4972;5077;43.4520;41.9439;44.9290
596248;249;125;124;37.4719;38.0200;36.9194
596256;1333;669;664;41.6710;40.5673;42.7831
596264;60;27;33;40.8833;37.8333;43.3788
596272;172;92;80;41.2093;39.1522;43.5750
596281;436;219;217;38.3372;38.7009;37.9700
596329;313;159;154;42.5767;41.3553;43.8377
596337;684;347;337;40.1681;39.5778;40.7760
511412;119;62;57;38.6345;39.9839;37.1667
596345;909;422;487;40.7673;41.1682;40.4199
596353;85;46;39;39.9000;38.9130;41.0641
596361;962;489;473;40.7422;40.0072;41.5021
596370;329;169;160;37.3997;36.5000;38.3500
596388;257;135;122;38.5856;36.4704;40.9262
596396;342;182;160;41.4152;38.9396;44.2313
596418;277;144;133;37.8538;36.3958;39.4323
549916;330;173;157;39.8485;38.7428;41.0669
596434;190;97;93;43.7368;44.3763;43.0699
596442;231;114;117;38.6212;38.2368;38.9957
596451;247;131;116;41.5648;40.7824;42.4483
596469;90;48;42;42.9222;44.1250;41.5476
596477;154;85;69;43.2857;41.6176;45.3406
596485;833;411;422;40.6525;40.9599;40.3531
596493;378;194;184;43.4074;41.5722;45.3424
596507;45;21;24;43.7222;45.2143;42.4167
588059;130;72;58;39.3462;36.4444;42.9483
596515;167;78;89;40.0988;39.7949;40.3652
596523;118;59;59;42.1186;41.1102;43.1271
596531;618;319;299;40.3544;39.6818;41.0719
549924;170;93;77;44.4412;41.5538;47.9286
596540;101;57;44;44.4307;43.5000;45.6364
596558;319;160;159;42.6285;43.5500;41.7013
596566;153;75;78;48.2908;46.7533;49.7692
596574;931;485;446;38.3056;36.8052;39.9372
587737;100;48;52;39.9500;38.6458;41.1538
549941;46;24;22;45.3261;45.6667;44.9545
596604;108;57;51;43.1296;37.9561;48.9118
596612;622;314;308;46.2653;44.9490;47.6071
596639;90;47;43;45.1556;40.7766;49.9419
596647;702;364;338;42.2792;41.7802;42.8166
596655;792;417;375;41.2374;39.7062;42.9400
596663;398;221;177;41.3970;40.2602;42.8164
596671;211;103;108;41.6469;39.8107;43.3981
596680;466;234;232;41.1395;39.5812;42.7112
596701;669;326;343;40.1129;39.8436;40.3688
588237;248;128;120;39.6411;39.2422;40.0667
596710;169;82;87;41.0740;40.3537;41.7529
596728;267;140;127;39.1255;37.7286;40.6654
596736;106;52;54;41.7642;45.2885;38.3704
596744;234;111;123;44.0897;42.8063;45.2480
596752;129;67;62;43.3217;40.9478;45.8871
596761;150;81;69;42.6933;40.0062;45.8478
596787;720;366;354;43.4278;43.2705;43.5904
596795;40;23;17;43.0250;40.6739;46.2059
596809;135;71;64;43.1000;40.3732;46.1250
596817;615;320;295;39.8398;38.0125;41.8220
596825;842;393;449;46.8824;44.9224;48.5980
549886;109;55;54;46.6743;45.2091;48.1667
596833;170;82;88;43.9588;42.2927;45.5114
596841;472;241;231;40.7458;41.3423;40.1234
596850;104;55;49;41.8269;41.7545;41.9082
596868;1407;720;687;46.0970;43.5653;48.7504
596876;656;315;341;45.1677;43.2651;46.9252
596884;721;361;360;43.0936;40.6967;45.4972
591831;675;339;336;39.6822;38.4056;40.9702
587753;109;52;57;42.3440;45.6538;39.3246
549959;93;46;47;46.0269;43.9783;48.0319
596906;368;202;166;34.2255;33.1535;35.5301
596914;467;228;239;42.4957;42.3816;42.6046
596922;264;141;123;40.6326;39.4433;41.9959
596931;191;97;94;43.6675;41.4278;45.9787
596949;322;165;157;43.1708;41.7424;44.6720
596957;710;379;331;41.1859;40.4499;42.0287
596965;332;164;168;42.2560;42.2561;42.2560
596973;5243;2592;2651;41.0070;39.8546;42.1337
596981;1228;621;607;38.2695;36.9718;39.5972
596990;127;66;61;41.0748;40.7273;41.4508
597007;11498;5619;5879;42.1266;40.2704;43.9007
587893;107;52;55;49.4065;48.4423;50.3182
597015;422;239;183;41.8720;39.4833;44.9918
597031;164;84;80;41.6280;42.2024;41.0250
597040;236;119;117;42.9449;41.7857;44.1239
597058;461;241;220;39.8536;39.6162;40.1136
597066;171;84;87;41.2778;40.0238;42.4885
597074;707;339;368;44.5877;43.6475;45.4538
587869;140;76;64;42.5286;42.1184;43.0156
597082;285;144;141;40.4123;39.0764;41.7766
597091;773;398;375;42.3771;41.0427;43.7933
588334;192;93;99;35.4271;33.3280;37.3990
597112;234;119;115;38.9530;38.9370;38.9696
597121;140;72;68;38.8786;37.2917;40.5588
597139;208;105;103;40.1250;37.9190;42.3738
597147;515;253;262;38.4340;39.0850;37.8053
597155;663;347;316;40.7941;39.9352;41.7373
597163;237;107;130;37.3439;38.7336;36.2000
595209;20717;9989;10728;44.5669;43.0169;46.0101
581291;4507;2219;2288;43.1767;41.8578;44.4559
581313;233;116;117;42.9421;40.1638;45.6966
581330;650;321;329;42.9246;41.7430;44.0775
581283;20484;9900;10584;43.8176;42.0920;45.4316
581356;431;202;229;45.5070;44.1683;46.6878
581364;1320;650;670;42.5841;41.3892;43.7433
581372;11681;5583;6098;43.0579;41.3800;44.5941
581381;359;176;183;41.5836;41.2670;41.8880
581445;428;209;219;38.2220;35.9402;40.3995
581453;590;288;302;38.4610;37.2882;39.5795
581461;241;123;118;40.2344;37.4187;43.1695
581470;761;400;361;42.4238;40.9025;44.1094
554162;175;93;82;42.7000;42.8441;42.5366
581496;2184;1018;1166;41.2560;39.8477;42.4854
581500;381;198;183;39.8596;37.6717;42.2268
581518;229;116;113;44.1812;43.0345;45.3584
581526;136;75;61;38.4044;33.5133;44.4180
581542;1402;726;676;41.7867;41.5579;42.0325
581551;1306;652;654;39.1524;37.7791;40.5214
581569;436;217;219;40.1055;37.9378;42.2534
581593;115;63;52;46.3174;43.0873;50.2308
581615;156;77;79;44.1667;42.1104;46.1709
581631;277;144;133;42.9765;41.7500;44.3045
513695;137;65;72;40.3686;39.6538;41.0139
581534;205;107;98;40.0268;40.7804;39.2041
581666;391;204;187;40.9194;40.0539;41.8636
581682;2810;1389;1421;42.6641;41.7023;43.6042
581721;170;95;75;42.7235;39.8579;46.3533
581739;916;467;449;40.4301;39.3608;41.5423
581755;357;186;171;41.2423;38.5591;44.1608
581763;921;450;471;42.3947;40.8756;43.8461
581771;121;56;65;43.6570;45.4821;42.0846
581780;444;222;222;36.4955;35.4099;37.5811
581798;157;82;75;43.3089;40.7561;46.1000
581801;489;242;247;42.9785;42.5413;43.4069
581810;218;108;110;42.6514;43.2685;42.0455
581828;832;412;420;44.1118;42.4951;45.6976
581836;163;87;76;49.4509;45.4080;54.0789
581844;58;32;26;42.4483;42.2500;42.6923
581852;180;95;85;39.9167;39.9737;39.8529
581861;299;146;153;41.1020;39.4589;42.6699
581879;2808;1350;1458;40.5228;39.4481;41.5178
581887;173;87;86;43.4884;43.1322;43.8488
581909;409;198;211;41.9279;40.4141;43.3483
581917;6745;3330;3415;43.3488;41.7763;44.8821
581925;411;205;206;41.7311;40.4512;43.0049
581933;136;72;64;43.0956;41.5278;44.8594
581941;44;25;19;42.3864;40.6600;44.6579
581950;1190;598;592;42.1487;40.5535;43.7601
581968;1345;645;700;42.5238;42.0008;43.0057
553875;63;33;30;51.5159;49.9545;53.2333
581992;92;47;45;44.5543;41.0957;48.1667
531006;337;170;167;39.6602;38.8118;40.5240
582018;1900;936;964;42.4137;41.8910;42.9212
582026;44;19;25;48.0227;50.6579;46.0200
582034;154;79;75;43.5844;43.4747;43.7000
582042;213;105;108;40.8052;40.2810;41.3148
582069;171;92;79;41.5468;38.5870;44.9937
582077;172;88;84;46.0756;44.2841;47.9524
582085;471;243;228;42.8715;41.6770;44.1447
582107;220;102;118;40.0818;38.7059;41.2712
582115;317;153;164;41.3612;41.1078;41.5976
582131;608;312;296;41.4243;40.5385;42.3581
582158;1657;814;843;43.3799;41.8243;44.8820
582166;1076;557;519;41.2770;40.1822;42.4518
582182;1137;573;564;43.4455;41.2016;45.7252
582191;256;135;121;39.0313;38.7889;39.3017
582204;126;67;59;43.2540;42.1567;44.5000
582212;650;328;322;40.9738;40.0457;41.9193
582221;281;155;126;41.7420;38.7323;45.4444
582239;3749;1887;1862;42.9068;41.2377;44.5983
582247;1353;686;667;42.1001;40.8980;43.3366
513709;129;54;75;42.8876;43.7222;42.2867
582271;571;298;273;38.0849;37.6644;38.5440
582280;142;76;66;43.6479;43.8289;43.4394
582298;950;471;479;41.8032;41.8142;41.7923
582310;627;330;297;41.4793;40.5788;42.4798
582328;585;281;304;39.2368;38.2687;40.1316
582336;619;308;311;41.4241;39.6104;43.2203
582344;109;50;59;41.9404;43.8800;40.2966
582352;972;478;494;42.7798;41.5377;43.9818
556963;642;335;307;42.0981;40.5209;43.8192
582620;164;85;79;43.9451;44.4529;43.3987
582395;477;231;246;41.5273;40.4913;42.5000
582409;454;225;229;39.8150;37.9000;41.6965
582417;303;148;155;39.2789;38.7770;39.7581
586064;244;130;114;40.2992;39.0615;41.7105
582433;367;189;178;40.4237;39.4153;41.4944
582441;1818;878;940;41.3251;40.2187;42.3585
582468;864;381;483;45.3021;42.0643;47.8561
582476;827;394;433;40.4927;39.3832;41.5023
582484;669;357;312;43.7586;41.6064;46.2212
582492;182;93;89;41.4121;40.7151;42.1404
582506;71;36;35;41.8099;43.8333;39.7286
582531;307;135;172;43.7443;42.6852;44.5756
534692;488;242;246;43.3832;41.8512;44.8902
582557;265;131;134;42.4774;42.0573;42.8881
582573;427;206;221;45.9941;45.6602;46.3054
553883;44;22;22;39.2045;37.5000;40.9091
582581;450;234;216;41.7533;40.8291;42.7546
582590;522;264;258;43.2835;41.9773;44.6202
582603;876;444;432;43.8014;42.4347;45.2060
582611;231;117;114;39.9805;38.7308;41.2632
530824;261;125;136;40.8257;40.6520;40.9853
582646;3643;1833;1810;44.3111;43.3063;45.3287
582654;343;177;166;41.7741;40.8277;42.7831
582662;255;131;124;41.0490;38.7366;43.4919
582671;546;266;280;41.5971;40.2970;42.8321
582689;383;194;189;40.0170;41.0928;38.9127
582701;780;387;393;43.3423;42.5026;44.1692
586005;140;70;70;43.9000;42.1571;45.6429
582727;214;107;107;42.4626;39.8925;45.0327
582743;412;210;202;43.6845;42.9952;44.4010
582751;768;391;377;41.2396;40.6483;41.8528
582760;259;143;116;40.4846;39.4371;41.7759
582778;78;41;37;43.5000;40.8415;46.4459
582786;381346;184925;196421;42.9012;41.1278;44.5708
582794;1333;670;663;39.2509;38.4881;40.0219
582808;756;357;399;39.6164;39.6317;39.6028
581321;191;97;94;45.0707;42.4381;47.7872
582824;3730;1864;1866;38.8300;37.2098;40.4486
582832;182;89;93;43.3462;43.8708;42.8441
582841;1232;616;616;39.4943;37.9968;40.9919
582859;2260;1121;1139;41.0673;39.5830;42.5281
595314;343;175;168;41.9286;41.3229;42.5595
595331;99;44;55;42.5202;43.5227;41.7182
582875;198;94;104;43.3535;43.1915;43.5000
593834;603;320;283;40.9594;38.9906;43.1855
582883;712;368;344;41.6713;39.7174;43.7616
581402;243;129;114;43.8169;42.6860;45.0965
581429;1088;526;562;38.0064;36.8346;39.1032
582891;321;158;163;44.5218;42.3544;46.6227
581437;84;46;38;40.0833;39.5000;40.7895
550272;634;325;309;40.9432;39.0692;42.9142
582913;1843;906;937;40.5564;39.6313;41.4509
595446;151;78;73;44.4735;44.5128;44.4315
582921;1015;500;515;42.6586;42.0320;43.2670
582930;438;223;215;42.7580;40.2578;45.3512
582948;1063;535;528;42.1943;41.6551;42.7405
582956;2468;1235;1233;41.8367;40.4215;43.2543
595527;1269;633;636;42.6931;41.7385;43.6431
582964;665;344;321;40.1887;39.1134;41.3411
595551;837;439;398;43.2061;42.3018;44.2035
595560;128;67;61;37.4297;36.8731;38.0410
582972;1913;952;961;36.9668;36.4391;37.4896
582999;614;312;302;36.1889;34.2051;38.2384
583014;211;106;105;44.2393;44.8774;43.5952
583022;300;155;145;43.6967;45.1194;42.1759
581577;92;47;45;44.1087;42.5851;45.7000
583031;1222;635;587;38.8658;37.9567;39.8492
595667;312;165;147;42.2340;39.3788;45.4388
583057;787;405;382;38.2039;37.0383;39.4398
583065;683;335;348;40.6859;40.2672;41.0891
583081;3553;1729;1824;40.5532;39.4132;41.6338
583090;336;161;175;41.0714;39.6118;42.4143
583111;982;506;476;40.3615;39.8202;40.9370
584517;734;361;373;43.6826;43.1842;44.1649
583120;9760;4816;4944;43.2332;41.8781;44.5532
583154;328;159;169;42.2378;41.3679;43.0562
583171;779;401;378;39.4666;38.6421;40.3413
583189;925;443;482;39.3108;38.6490;39.9191
595837;283;140;143;42.4258;41.9500;42.8916
583197;1031;519;512;38.0645;38.4653;37.6582
587907;270;136;134;35.9815;36.3235;35.6343
583201;605;299;306;42.6851;42.0719;43.2843
583219;1150;548;602;39.4078;39.7591;39.0880
583227;667;325;342;41.3996;40.3062;42.4386
583235;461;240;221;42.3351;41.8792;42.8303
595934;226;123;103;40.9292;38.4268;43.9175
583243;343;176;167;36.1560;34.0341;38.3922
583251;10993;5374;5619;40.6415;39.3143;41.9109
595985;132;67;65;43.5303;40.5597;46.5923
595993;176;79;97;41.2898;41.8797;40.8093
583260;726;368;358;43.0207;41.9620;44.1089
583278;214;104;110;42.5514;42.2212;42.8636
583286;1914;944;970;41.4478;40.5837;42.2887
583294;276;142;134;40.1848;40.3592;40.0000
583308;131;66;65;41.6679;42.4242;40.9000
594377;530;277;253;40.1811;38.7563;41.7411
581976;1457;729;728;40.8624;39.0940;42.6332
583316;538;266;272;39.7900;40.4962;39.0993
596078;48;22;26;42.7083;40.5909;44.5000
583324;627;302;325;42.9338;41.4702;44.2938
583332;706;347;359;35.5807;35.8199;35.3496
583341;990;493;497;41.9929;41.6400;42.3431
583359;516;250;266;40.9903;41.6880;40.3346
583367;872;433;439;40.6032;38.4030;42.7733
583375;486;239;247;42.3045;41.6925;42.8968
583383;1862;929;933;39.8818;38.5452;41.2128
583391;5329;2656;2673;41.1821;39.9688;42.3878
583405;2759;1332;1427;41.6914;40.7868;42.5357
583413;3313;1581;1732;36.2054;35.1781;37.1432
583421;990;498;492;42.9404;42.0020;43.8902
583430;1032;524;508;40.1812;39.4943;40.8898
583448;1194;604;590;41.3132;40.1805;42.4729
583456;817;388;429;39.8966;41.3454;38.5862
596175;1335;652;683;44.2536;43.3773;45.0900
583464;91;42;49;54.3352;48.2381;59.5612
583472;323;155;168;39.9334;39.9581;39.9107
583481;957;471;486;40.5752;39.4745;41.6420
583499;325;162;163;41.3800;39.1235;43.6227
596191;239;120;119;38.0146;36.2917;39.7521
584720;1364;703;661;41.0968;39.7532;42.5257
583502;801;392;409;40.7772;40.7398;40.8130
583511;738;365;373;41.6436;39.9658;43.2855
583529;227;107;120;39.7203;41.9019;37.7750
583537;1466;735;731;41.6535;41.0673;42.2428
582123;124;60;64;43.5887;43.6000;43.5781
596302;333;167;166;39.9745;40.1766;39.7711
583545;817;410;407;42.2613;40.8415;43.6916
583553;1119;545;574;41.4464;40.9128;41.9530
583561;2785;1378;1407;41.2368;39.9245;42.5220
582174;118;62;56;45.7458;41.3387;50.6250
583588;4684;2367;2317;42.4507;41.2520;43.6752
583596;1802;955;847;41.6931;40.4298;43.1175
583600;706;373;333;42.0312;40.5134;43.7312
506699;366;187;179;37.3142;36.5588;38.1034
584762;739;379;360;40.9804;39.5871;42.4472
596400;192;97;95;41.8646;40.1495;43.6158
583634;1458;759;699;40.8553;39.5237;42.3011
584801;5133;2512;2621;41.6089;40.3646;42.8014
549738;443;216;227;39.1275;37.7870;40.4031
583651;356;166;190;41.3764;39.6145;42.9158
583669;1641;829;812;36.3172;34.9910;37.6712
583677;2339;1159;1180;40.7950;39.3473;42.2169
583685;938;470;468;41.3646;40.6021;42.1303
583693;614;330;284;40.5098;38.1485;43.2535
583707;971;483;488;42.4547;41.3923;43.5061
549746;1408;703;705;43.3089;42.0064;44.6078
584843;1042;533;509;42.0806;41.0666;43.1424
583715;656;319;337;41.7470;40.5000;42.9273
583723;518;258;260;40.5618;38.0814;43.0231
583731;886;438;448;43.1196;42.8402;43.3929
583740;772;402;370;41.3964;39.9925;42.9216
583758;3928;1886;2042;40.0588;38.1638;41.8090
583766;1490;718;772;40.4181;39.3928;41.3718
582255;241;128;113;43.3714;42.5313;44.3230
583774;997;478;519;39.3495;39.4121;39.2919
582263;232;114;118;43.4483;42.6491;44.2203
596582;74;41;33;43.2568;41.9878;44.8333
583782;6291;3090;3201;40.3935;38.7184;42.0105
583791;1075;542;533;41.4470;40.8487;42.0553
583804;405;196;209;41.1346;38.6990;43.4187
583821;818;413;405;41.7103;41.3668;42.0605
583839;2101;1029;1072;40.9969;39.9820;41.9711
549789;388;195;193;40.7526;40.5513;40.9560
596698;49;23;26;34.0510;31.2391;36.5385
591661;390;199;191;46.3513;45.4447;47.2958
583847;643;323;320;41.1750;42.0139;40.3281
583855;871;434;437;43.2072;41.6336;44.7700
583863;1116;551;565;39.3118;38.5799;40.0257
545295;161;85;76;42.6863;40.7471;44.8553
549894;69;37;32;44.2101;39.3649;49.8125
583880;617;306;311;38.8160;37.2124;40.3939
583898;2369;1188;1181;40.5684;39.1481;41.9970
583901;406;202;204;38.5320;36.4059;40.6373
582379;135;64;71;43.3444;40.1563;46.2183
583910;3036;1532;1504;41.3090;40.3930;42.2420
583928;445;226;219;41.6978;39.5044;43.9612
582450;120;66;54;46.4917;44.4848;48.9444
583936;1874;974;900;35.9194;34.4723;37.4856
583944;341;170;171;38.8167;37.6000;40.0263
583952;7599;3699;3900;41.9265;40.5754;43.2079
583961;509;257;252;42.6572;41.7451;43.5873
594903;282;151;131;40.2979;37.7252;43.2634
583979;1618;804;814;40.2410;38.9440;41.5221
583995;1257;626;631;40.7029;39.2971;42.0975
583987;1167;564;603;42.5249;41.7961;43.2065
584002;9258;4335;4923;41.4078;39.6629;42.9442
596892;87;42;45;41.5000;45.0714;38.1667
584011;380;189;191;41.7868;39.4312;44.1178
594962;681;329;352;41.6307;39.2812;43.8267
584029;2328;1125;1203;41.2805;40.5996;41.9173
584037;1323;650;673;41.7268;40.3431;43.0632
584045;3387;1619;1768;42.9411;40.7557;44.9423
584053;298;156;142;43.0705;43.3013;42.8169
549908;135;68;67;42.2926;40.1618;44.4552
582565;234;123;111;42.5556;41.9878;43.1847
584061;756;388;368;41.1799;40.2680;42.1413
584070;132;70;62;42.2197;41.5429;42.9839
584096;760;371;389;38.7974;38.2682;39.3021
584100;3376;1619;1757;41.6001;40.2678;42.8278
584118;941;478;463;41.9017;40.2803;43.5756
584126;1357;673;684;40.2634;39.2637;41.2471
585025;871;426;445;41.2233;40.9554;41.4798
584134;194;95;99;37.9536;38.3421;37.5808
584142;1200;602;598;41.8950;41.1927;42.6020
584151;836;418;418;40.7871;39.8182;41.7560
585033;2417;1211;1206;40.3726;38.8344;41.9171
597104;94;51;43;41.6915;39.3235;44.5000
584169;284;146;138;38.2746;36.3356;40.3261
584177;721;356;365;42.1657;41.2781;43.0315
584185;788;374;414;40.5114;38.8182;42.0411
584193;66;34;32;44.6818;41.7647;47.7813
584207;2573;1225;1348;43.8579;41.3139;46.1699
584215;1240;610;630;43.4694;41.3279;45.5429
584223;3775;1880;1895;42.8592;41.3638;44.3427
582735;70;38;32;36.7000;36.8158;36.5625
584231;1651;826;825;42.3019;40.1913;44.4152
584240;904;463;441;39.6538;37.6339;41.7744
597171;378;207;171;40.2619;39.4855;41.2018
584266;1792;890;902;40.6328;39.5854;41.6663
584274;500;245;255;40.9540;41.8347;40.1078
584282;3834;1869;1965;41.0222;39.3208;42.6405
584304;407;203;204;42.1486;40.9039;43.3873
584321;912;437;475;42.3980;42.0126;42.7526
584339;838;424;414;40.8270;40.0613;41.6111
584347;1294;651;643;42.0796;40.6029;43.5747
584355;520;242;278;45.8673;44.4050;47.1403
584363;985;496;489;42.8513;41.1714;44.5552
584291;24743;11923;12820;43.5650;41.6928;45.3062
584371;1657;846;811;40.7704;39.3452;42.2571
584380;747;376;371;42.7463;40.9016;44.6159
584401;510;259;251;40.7373;40.2181;41.2729
584410;464;221;243;38.7306;37.1968;40.1255
584428;1697;855;842;43.6591;42.0170;45.3266
584436;310;169;141;45.3516;44.5355;46.3298
584444;1819;923;896;41.0728;39.6170;42.5725
584452;1303;647;656;42.5460;40.8107;44.2576
584461;663;312;351;43.4668;42.7660;44.0897
584479;486;247;239;42.2942;40.1194;44.5418
584487;1618;802;816;41.4363;41.1771;41.6912
584495;5975;2896;3079;42.5452;40.9313;44.0632
584525;688;351;337;39.4622;39.4487;39.4763
550256;201;103;98;44.9776;43.6165;46.4082
584541;515;230;285;47.0903;42.8174;50.5386
584550;2501;1273;1228;41.8183;39.6469;44.0692
584568;2052;1012;1040;44.5960;42.8735;46.2721
584576;1905;941;964;43.4549;41.7370;45.1317
584584;1230;602;628;42.3301;41.0000;43.6051
584592;1321;665;656;40.5901;39.2233;41.9756
555282;439;231;208;39.2995;39.6818;38.8750
558443;1231;596;635;44.6803;43.7685;45.5362
584622;3698;1810;1888;43.4319;41.6834;45.1081
584631;2272;1130;1142;44.0792;43.0327;45.1147
584649;7455;3584;3871;43.0860;41.7059;44.3639
584657;458;226;232;42.2555;42.2345;42.2759
584665;2615;1267;1348;42.6969;41.9104;43.4362
584673;1463;727;736;42.1213;40.9897;43.2391
584681;492;254;238;42.0346;40.5118;43.6597
584703;710;357;353;42.0296;40.7101;43.3640
584711;776;393;383;41.8686;41.1972;42.5574
584746;1221;595;626;40.5098;39.2950;41.6645
584754;324;160;164;41.3889;39.9125;42.8293
584771;592;286;306;42.2247;41.4860;42.9150
584789;786;397;389;42.0025;41.6083;42.4049
584797;3019;1509;1510;43.7908;42.3144;45.2662
584819;946;460;486;41.6596;40.3891;42.8621
584835;765;385;380;43.1105;41.8948;44.3421
584851;799;397;402;44.6114;42.9635;46.2388
584860;2197;1136;1061;42.8710;41.1998;44.6602
584878;866;441;425;43.7644;42.7132;44.8553
584894;920;450;470;41.5576;40.1356;42.9191
584908;879;459;420;41.2622;39.4891;43.2000
584916;808;401;407;44.1411;43.9738;44.3059
584924;1487;724;763;43.7246;41.8660;45.4882
584932;2064;1048;1016;41.0010;39.8893;42.1476
584941;2108;1045;1063;43.1385;41.2837;44.9619
584959;1109;555;554;43.4711;41.5973;45.3484
584967;1056;523;533;41.4015;41.1099;41.6876
584975;3575;1754;1821;44.1537;42.4527;45.7921
584983;3889;1896;1993;42.4180;41.0095;43.7579
584991;505;248;257;39.8743;39.3710;40.3599
585009;1772;910;862;41.6428;39.6923;43.7019
585017;3140;1548;1592;42.8758;41.1447;44.5590
585041;1070;536;534;43.6766;41.4590;45.9026
585050;1424;701;723;41.3883;39.7825;42.9454
586030;882;448;434;44.9127;43.7210;46.1429
586048;2018;992;1026;45.7076;44.1845;47.1803
586056;424;222;202;44.8915;43.4189;46.5099
586072;690;343;347;45.7101;43.9665;47.4337
586081;4389;2154;2235;43.2501;41.5729;44.8664
586099;1249;635;614;43.8323;41.7173;46.0195
586102;2437;1235;1202;43.3293;40.9575;45.7662
586111;404;195;209;47.2302;45.8590;48.5096
586129;1421;712;709;39.6921;38.1292;41.2616
586137;3013;1522;1491;41.0121;39.8219;42.2270
586145;1019;500;519;41.7395;40.4680;42.9644
586153;269;132;137;42.4071;41.0833;43.6825
586161;6352;3154;3198;43.4491;41.9613;44.9165
586021;24512;11850;12662;44.0708;42.2051;45.8169
586170;2185;1044;1141;43.3398;40.4952;45.9426
586188;1240;609;631;43.4524;41.6084;45.2322
586196;638;313;325;44.5925;43.5703;45.5769
586200;410;202;208;41.2024;39.6040;42.7548
586218;705;349;356;42.9965;40.5401;45.4045
586226;713;350;363;43.4972;42.2457;44.7039
586234;430;235;195;41.0558;38.0106;44.7256
586242;228;111;117;46.4737;43.3018;49.4829
586251;248;117;131;41.6089;38.4145;44.4618
586269;1100;540;560;43.9309;42.1704;45.6286
586277;889;463;426;41.5529;39.7397;43.5235
586285;512;254;258;41.3184;40.8622;41.7674
586293;413;208;205;42.3717;40.4471;44.3244
586307;11185;5458;5727;45.3631;43.3712;47.2615
586315;175;92;83;46.5400;46.2283;46.8855
586323;1496;736;760;43.4258;41.8533;44.9487
586331;943;484;459;44.9305;43.3430;46.6046
586340;813;402;411;42.2921;41.4701;43.0961
586358;2957;1447;1510;42.9883;41.9285;44.0040
586366;161;91;70;45.6863;42.7857;49.4571
586374;1946;960;986;42.2174;41.2833;43.1268
586382;1878;940;938;41.4776;40.1713;42.7868
586391;733;389;344;45.0239;42.5668;47.8023
586404;2075;1007;1068;43.1795;42.6668;43.6629
593354;299;158;141;43.3963;43.0253;43.8121
586412;3675;1860;1815;41.7558;40.3892;43.1562
586421;859;427;432;42.8749;40.7646;44.9606
586439;346;165;181;42.4711;40.4273;44.3343
586447;474;231;243;42.3966;41.5952;43.1584
586455;656;343;313;43.5716;42.8265;44.3882
586463;217;114;103;43.2419;40.0789;46.7427
586471;222;111;111;44.4595;42.8784;46.0405
586480;1328;659;669;42.7312;41.8976;43.5523
586498;2230;1111;1119;42.6731;40.6593;44.6725
586501;850;432;418;43.8753;42.7662;45.0215
586510;4015;1957;2058;43.5453;42.1500;44.8722
586528;3492;1747;1745;44.5200;42.9699;46.0719
586536;151;78;73;48.7517;47.4872;50.1027
586544;546;270;276;42.8242;41.6407;43.9819
586552;848;413;435;44.6132;42.2869;46.8218
586561;959;485;474;42.4072;41.6237;43.2089
586579;362;187;175;44.6243;41.9759;47.4543
586587;5537;2758;2779;44.3443;41.9833;46.6875
586595;590;309;281;42.8746;41.4579;44.4324
586609;1262;609;653;42.3597;41.4704;43.1891
586617;498;251;247;45.5261;44.6912;46.3745
586625;3530;1778;1752;42.5380;40.4049;44.7026
586633;353;186;167;44.8031;42.5430;47.3204
586641;2181;1076;1105;43.6307;42.0762;45.1443
586650;552;265;287;42.2029;41.5528;42.8031
586668;908;439;469;41.2731;40.3588;42.1290
586676;383;188;195;44.9099;42.2713;47.4538
586684;930;460;470;42.6785;40.4761;44.8340
586692;766;375;391;41.2611;39.9507;42.5179
586706;2209;1124;1085;42.0378;41.2313;42.8733
586714;2892;1450;1442;44.9710;43.0269;46.9258
586722;10889;5263;5626;44.6414;42.8067;46.3578
586731;487;257;230;43.6417;42.2471;45.2000
586749;1040;529;511;43.3885;42.1352;44.6859
586757;3003;1465;1538;42.7394;41.5799;43.8440
586765;4570;2221;2349;42.7107;41.0160;44.3131
586773;586;298;288;46.0188;45.6174;46.4340
586781;749;397;352;44.3732;42.3489;46.6563
586790;1131;556;575;40.7767;39.2968;42.2078
586803;2502;1250;1252;43.8461;42.2048;45.4848
586811;509;243;266;45.5786;45.8086;45.3684
586820;1022;490;532;44.8659;44.0265;45.6391
586838;183;93;90;48.6585;46.7581;50.6222
592897;250;116;134;43.8680;42.4914;45.0597
592901;861;429;432;41.7300;40.4790;42.9722
592919;1254;622;632;39.4928;37.9502;41.0111
592927;891;449;442;42.5954;40.9566;44.2602
592935;0;0;0;0.0000;0.0000;0.0000
592943;6493;3179;3314;42.4081;41.0788;43.6832
592978;266;133;133;42.2782;41.1391;43.4173
592986;229;111;118;40.9934;43.8063;38.3475
592994;940;460;480;41.6894;40.7435;42.5958
593001;2388;1186;1202;42.7672;41.0337;44.4775
593010;595;291;304;39.7521;38.2835;41.1579
593028;865;434;431;41.0491;38.9608;43.1520
550213;863;429;434;38.5800;37.8613;39.2903
593036;495;245;250;42.1545;40.6959;43.5840
593044;1030;503;527;41.0223;40.3887;41.6271
550825;1395;718;677;36.8534;36.3022;37.4380
593052;858;429;429;42.5000;41.7378;43.2622
593061;616;320;296;42.3084;41.9688;42.6757
593079;775;371;404;42.4355;42.2062;42.6460
593087;566;272;294;47.2438;42.4522;51.6769
593095;247;129;118;45.5567;43.1589;48.1780
593117;2923;1448;1475;43.1647;41.5628;44.7373
593125;393;192;201;43.3855;42.9740;43.7786
593141;721;364;357;39.9688;39.9863;39.9510
593150;317;171;146;41.7208;40.4474;43.2123
593168;722;366;356;42.0097;40.2459;43.8230
550108;361;194;167;42.3116;40.5155;44.3982
593184;113;62;51;45.0929;44.4032;45.9314
593192;419;205;214;42.4642;41.8951;43.0093
593214;1955;983;972;41.5384;39.0239;44.0813
593222;802;408;394;42.0661;41.1348;43.0305
593231;134;63;71;41.9627;41.0079;42.8099
593249;490;234;256;41.4286;40.5427;42.2383
593257;1394;683;711;42.7884;42.7255;42.8488
593265;711;347;364;39.6083;39.2983;39.9038
593273;958;474;484;41.1983;40.1561;42.2190
593281;272;146;126;40.3346;39.1096;41.7540
593290;138;78;60;44.0870;42.9744;45.5333
550141;340;163;177;40.6706;39.9356;41.3475
593320;687;356;331;40.7373;38.8708;42.7447
593338;350;184;166;44.7371;43.5054;46.1024
593346;562;291;271;42.9875;41.4003;44.6919
557048;465;237;228;41.2484;41.3523;41.1404
593371;793;398;395;41.2427;38.9623;43.5405
593389;289;148;141;44.0156;42.5203;45.5851
593397;749;376;373;40.7937;40.2367;41.3552
593401;409;215;194;44.0868;42.9512;45.3454
593419;1080;560;520;44.5074;42.8018;46.3442
593427;413;219;194;43.0666;42.4224;43.7938
593435;729;357;372;42.2366;40.8810;43.5376
593443;108;58;50;43.7685;43.5000;44.0800
550132;600;313;287;40.8767;40.0974;41.7265
593460;322;163;159;43.6429;41.4509;45.8899
593478;1611;820;791;40.3597;39.4159;41.3382
550795;245;118;127;41.3327;37.7966;44.6181
593486;170;90;80;45.7353;45.2556;46.2750
550175;442;221;221;41.6357;40.7534;42.5181
593494;644;330;314;40.7298;39.6212;41.8949
593508;1831;914;917;39.8048;38.6554;40.9504
593516;1238;623;615;40.7415;39.8949;41.5992
593524;418;221;197;41.4569;40.0430;43.0431
593532;695;352;343;39.7734;37.9716;41.6224
554898;534;264;270;39.6461;39.3674;39.9185
593559;5694;2754;2940;41.3869;40.6899;42.0398
593567;598;306;292;42.2993;40.3758;44.3151
553972;272;134;138;40.9706;40.3657;41.5580
593583;6916;3334;3582;40.7491;39.4172;41.9888
593591;338;172;166;43.7604;41.3721;46.2349
593605;491;242;249;45.6792;45.6612;45.6968
593613;1056;525;531;40.7576;39.6714;41.8315
593621;1022;517;505;40.0822;39.5600;40.6168
593630;363;183;180;39.2218;38.2213;40.2389
593648;604;315;289;41.9884;40.0873;44.0606
550191;258;134;124;43.7326;41.4925;46.1532
593656;465;242;223;41.0376;39.1777;43.0561
593664;720;357;363;41.1792;39.8866;42.4504
593681;1272;650;622;39.6156;38.7815;40.4871
592889;20807;10107;10700;43.4622;41.8136;45.0194
593699;681;342;339;37.4134;36.1696;38.6681
593702;299;147;152;40.6171;40.3231;40.9013
593729;284;140;144;39.7887;38.1786;41.3542
593737;373;190;183;43.5965;42.8158;44.4071
593745;212;110;102;41.3302;37.5000;45.4608
593753;149;82;67;49.6611;46.5732;53.4403
593761;85;44;41;42.9235;46.0455;39.5732
593770;1153;587;566;42.5867;40.6874;44.5565
593788;647;320;327;43.7195;42.7438;44.6743
593796;193;110;83;43.4948;40.6909;47.2108
593800;439;240;199;37.4567;37.2792;37.6709
593818;156;83;73;43.5705;43.5120;43.6370
593826;1554;757;797;40.6010;39.5185;41.6292
593842;818;382;436;44.3741;43.4058;45.2225
593851;593;298;295;38.7563;38.2416;39.2763
593869;299;155;144;46.8880;46.8226;46.9583
593877;220;119;101;42.1909;40.1975;44.5396
593885;92;40;52;48.9457;43.4250;53.1923
593893;142;82;60;42.5000;41.0854;44.4333
593907;348;180;168;42.9684;41.2444;44.8155
593923;264;133;131;43.0530;42.3045;43.8130
593931;388;191;197;42.9948;42.6099;43.3680
546941;2445;1240;1205;42.7732;42.3105;43.2494
593958;140;67;73;45.4714;44.6791;46.1986
593966;484;245;239;42.7934;42.4592;43.1360
593974;861;446;415;40.7846;39.0673;42.6301
593982;568;280;288;39.2993;39.6536;38.9549
593991;492;248;244;41.8455;41.2177;42.4836
594008;144;73;71;42.5694;40.9110;44.2746
594016;209;110;99;39.3947;37.7636;41.2071
594024;324;165;159;42.6605;42.7242;42.5943
594032;1428;731;697;40.5490;39.0814;42.0882
594041;846;435;411;41.9421;40.8655;43.0815
594059;362;170;192;37.0000;37.5294;36.5313
594067;1820;909;911;39.6181;37.9631;41.2695
594075;265;129;136;42.1000;43.1744;41.0809
594083;289;150;139;45.7976;43.8333;47.9173
594091;615;311;304;43.6610;42.6511;44.6941
594105;303;154;149;41.5066;39.1234;43.9698
594113;1559;786;773;41.6514;40.2328;43.0938
594121;420;213;207;47.3238;45.5423;49.1570
594130;886;471;415;42.6163;41.8567;43.4783
594148;956;490;466;40.8923;39.5592;42.2940
594156;3339;1673;1666;41.8564;40.8389;42.8782
594164;100;58;42;48.6800;44.9655;53.8095
594172;651;310;341;38.5276;38.6000;38.4619
594181;434;224;210;41.5438;40.9688;42.1571
594199;1268;638;630;40.2957;39.8746;40.7222
594202;1176;594;582;43.7083;42.0875;45.3625
594211;794;399;395;40.7040;40.2594;41.1532
594229;458;232;226;41.2293;39.3147;43.1947
550841;56;28;28;45.1071;42.1786;48.0357
594237;154;70;84;43.3052;46.0143;41.0476
594253;158;84;74;44.1392;39.9524;48.8919
594261;586;278;308;42.2474;40.7158;43.6299
594270;575;283;292;39.2043;38.7473;39.6473
594288;103;58;45;48.0534;46.8966;49.5444
550086;242;119;123;41.4628;39.0882;43.7602
594296;154;83;71;40.0714;40.3193;39.7817
594300;924;449;475;42.8409;41.1459;44.4432
594318;146;66;80;42.1918;41.1667;43.0375
594326;223;107;116;41.9619;41.9206;42.0000
594334;575;284;291;37.4652;37.4190;37.5103
594342;251;130;121;42.6434;40.9769;44.4339
594351;246;125;121;42.1179;42.1880;42.0455
594369;476;242;234;40.4832;40.4421;40.5256
594385;66;32;34;45.5909;43.9063;47.1765
594393;256;138;118;43.8359;41.1304;47.0000
594407;371;184;187;39.1388;40.7174;37.5856
594415;527;257;270;40.4070;39.5973;41.1778
594423;172;91;81;47.4128;47.3242;47.5123
594431;660;327;333;42.6879;43.0688;42.3138
594440;199;105;94;43.1985;42.0143;44.5213
594458;2990;1478;1512;42.4538;40.7821;44.0880
594466;322;158;164;47.9441;48.3861;47.5183
594474;227;113;114;47.3502;45.5796;49.1053
594482;5715;2734;2981;44.2417;43.2495;45.1518
594512;206;109;97;38.7087;38.6835;38.7371
594521;84;48;36;45.3929;43.5833;47.8056
587729;1595;800;795;39.0342;38.4550;39.6170
594555;525;264;261;40.2886;40.1894;40.3889
594563;1149;593;556;40.9761;39.8828;42.1421
594571;662;345;317;42.9063;41.3464;44.6041
594580;73;37;36;46.6918;44.4459;49.0000
594598;81;40;41;50.0926;47.3000;52.8171
594601;480;237;243;40.8333;40.7827;40.8827
594610;376;188;188;42.6436;42.4202;42.8670
594628;459;219;240;47.6874;44.4726;50.6208
550051;369;184;185;40.9770;39.0707;42.8730
594636;50;24;26;58.9400;57.0417;60.6923
594644;163;85;78;47.1380;43.9235;50.6410
594652;102;61;41;41.9118;41.4508;42.5976
594679;804;404;400;38.3259;38.0050;38.6500
594687;348;171;177;40.3333;39.3772;41.2571
594695;88;48;40;42.8523;40.3750;45.8250
594709;866;419;447;42.2333;40.0847;44.2472
550078;101;53;48;42.4109;39.5755;45.5417
594725;334;175;159;45.5299;42.6714;48.6761
594733;171;84;87;47.8509;47.0714;48.6034
594741;98;51;47;48.5204;43.8922;53.5426
594750;444;232;212;42.2095;41.0517;43.4764
594768;515;242;273;43.1738;42.1488;44.0824
594776;239;111;128;44.1778;43.4550;44.8047
594784;496;257;239;41.2298;40.2393;42.2950
594792;123;60;63;41.1260;37.5000;44.5794
594806;223;114;109;45.3072;43.9298;46.7477
594814;292;147;145;37.2740;34.8401;39.7414
594822;1015;522;493;40.2094;39.0441;41.4432
594831;154;72;82;50.7208;52.6667;49.0122
555231;1413;724;689;39.8999;39.2528;40.5798
594849;499;264;235;40.5080;38.8371;42.3851
594865;151;84;67;41.7781;42.3571;41.0522
594873;1522;774;748;41.6689;40.6731;42.6992
594881;1121;545;576;42.3805;41.6303;43.0903
594890;611;314;297;43.0368;41.7994;44.3451
594911;632;320;312;42.1392;40.7438;43.5705
594920;1375;712;663;41.5269;39.6292;43.5649
594938;599;319;280;44.0376;44.5972;43.4000
594946;580;298;282;40.8362;39.9463;41.7766
594954;120;56;64;41.2667;39.5179;42.7969
594971;549;276;273;43.4126;42.7790;44.0531
594989;193;87;106;45.7332;45.1207;46.2358
594997;427;220;207;41.8326;40.7864;42.9444
595004;375;172;203;44.3053;44.6977;43.9729
595012;80;43;37;43.1625;42.1279;44.3649
595021;1292;656;636;40.9420;40.2912;41.6132
595039;423;206;217;40.0343;40.1214;39.9516
595047;850;428;422;42.8965;40.5444;45.2820
545325;393;193;200;43.9733;41.6917;46.1750
595055;693;371;322;44.4293;42.2682;46.9193
595063;68;38;30;47.5294;46.1842;49.2333
595071;1075;535;540;44.4777;43.7766;45.1722
595080;251;127;124;40.3685;39.2165;41.5484
550019;190;82;108;40.3105;42.1463;38.9167
595098;816;417;399;45.7953;44.1355;47.5301
595101;310;150;160;41.2129;42.3600;40.1375
595110;298;151;147;42.6812;42.8046;42.5544
595128;1183;598;585;38.6927;37.6171;39.7923
595136;175;91;84;42.4371;40.4780;44.5595
595144;92;43;49;45.3804;44.9651;45.7449
595152;172;87;85;46.6047;46.1897;47.0294
595161;43;23;20;52.5465;53.6304;51.3000
593711;33765;15976;17789;43.3881;41.4719;45.1090
595179;277;137;140;44.6119;42.0401;47.1286
595187;361;199;162;42.9543;42.7613;43.1914
595195;273;146;127;40.9286;39.2534;42.8543
523917;1770;893;877;42.9667;42.0890;43.8603
524891;861;448;413;39.8879;39.2277;40.6041
525227;323;164;159;35.3235;34.5793;36.0912
533491;536;277;259;43.8657;41.1354;46.7857
569356;2393;1189;1204;42.9697;42.2140;43.7159
553301;401;198;203;39.6945;38.6162;40.7463
536148;2755;1352;1403;43.9878;42.4926;45.4287
536385;11081;5307;5774;44.9555;43.0728;46.6858
557218;378;179;199;48.5212;45.3380;51.3844
540030;2118;1043;1075;44.7162;43.0906;46.2935
540382;2501;1247;1254;43.8411;42.3003;45.3732
569330;164;89;75;44.7500;44.5112;45.0333
540684;972;481;491;43.8416;43.6019;44.0764
553484;720;359;361;44.6694;44.0682;45.2673
541036;624;323;301;41.4824;40.8344;42.1777
541117;672;351;321;44.5298;42.9587;46.2477
541214;473;254;219;46.5000;44.0591;49.3311
541249;1322;734;588;44.0855;43.1063;45.3078
553468;721;378;343;41.9341;40.1667;43.8819
569453;545;285;260;42.9771;41.4930;44.6038
541303;1266;620;646;43.0790;41.5516;44.5449
541346;401;197;204;43.4651;43.7640;43.1765
597996;3748;1870;1878;44.7609;43.1316;46.3834
541575;1223;612;611;43.4689;42.6275;44.3118
552356;451;224;227;42.5177;41.1384;43.8789
500526;2309;1159;1150;40.5749;39.3723;41.7870
500623;1153;599;554;43.9484;42.4566;45.5614
552062;229;113;116;40.9716;38.7655;43.1207
500801;642;328;314;42.3240;42.4695;42.1720
500852;2549;1276;1273;42.8339;41.2406;44.4309
500861;1502;754;748;43.6505;42.1167;45.1965
552402;649;322;327;40.5678;39.8913;41.2339
500879;819;410;409;40.6453;39.9098;41.3826
547026;1022;526;496;40.1350;39.1635;41.1653
552186;1442;714;728;42.1657;41.1835;43.1291
552445;617;302;315;43.1953;41.6391;44.6873
501476;2004;1001;1003;41.5230;40.9046;42.1401
501646;2782;1376;1406;40.0435;39.2413;40.8286
568392;1347;661;686;40.7918;40.1702;41.3907
545279;490;242;248;40.9857;40.7562;41.2097
552313;337;172;165;41.2418;41.5872;40.8818
501751;1743;888;855;42.8264;41.0360;44.6860
501794;1645;825;820;41.2331;40.0721;42.4012
552071;253;123;130;37.1206;36.4350;37.7692
501841;1539;756;783;41.7021;40.3254;43.0313
552178;455;229;226;42.4538;38.7358;46.2212
552330;223;113;110;39.0830;38.2788;39.9091
502146;4246;2100;2146;43.0525;41.1857;44.8793
552020;942;475;467;35.3705;35.0621;35.6842
502235;1851;940;911;39.4373;39.1777;39.7053
502405;634;308;326;39.6562;38.6299;40.6258
502545;2499;1244;1255;41.4664;40.2572;42.6649
569798;333;177;156;38.4039;36.9181;40.0897
546976;150;84;66;43.0533;40.8690;45.8333
597414;565;280;285;41.2805;41.1286;41.4298
568872;887;441;446;39.5192;39.3934;39.6435
502839;744;366;378;41.6505;40.3197;42.9392
503142;592;298;294;40.8547;41.4295;40.2721
547123;206;106;100;48.0922;44.7170;51.6700
500135;219;110;109;43.1210;42.6727;43.5734
503304;872;431;441;42.7706;41.0429;44.4592
552437;485;229;256;42.5619;42.8275;42.3242
554901;1753;855;898;41.5462;41.2298;41.8474
503941;0;0;0;0.0000;0.0000;0.0000
569003;641;311;330;41.9509;40.7765;43.0576
552305;167;89;78;41.6617;41.5225;41.8205
540005;199;106;93;43.7764;44.0849;43.4247
503444;9738;4790;4948;43.5118;42.1944;44.7872
552232;647;339;308;43.8076;41.5914;46.2468
552038;200;101;99;44.9150;42.5099;47.3687
552216;487;243;244;44.1448;44.8251;43.4672
503622;871;413;458;43.5838;41.3354;45.6114
503657;3246;1630;1616;42.1288;41.4080;42.8558
569844;405;194;211;41.2877;40.7938;41.7417
503738;1198;621;577;41.4399;40.0523;42.9333
552372;1613;800;813;40.7629;39.1250;42.3745
568911;259;123;136;42.0598;41.6382;42.4412
500160;603;325;278;40.5166;39.1615;42.1007
504246;751;413;338;42.6678;42.9019;42.3817
552348;726;361;365;40.0441;39.7022;40.3822
597678;2934;1496;1438;42.0508;40.7005;43.4555
554944;683;350;333;41.4297;39.1857;43.7883
547093;48;29;19;46.2292;46.1552;46.3421
504441;1514;756;758;41.5092;40.5635;42.4525
504505;2107;1041;1066;42.7136;40.9707;44.4156
597686;258;145;113;46.6434;44.9483;48.8186
552381;771;398;373;43.1355;41.5427;44.8351
552259;225;111;114;42.8556;43.0495;42.6667
500496;100663;47748;52915;42.7014;40.8198;44.3993
504785;1297;669;628;40.3697;39.2220;41.5924
552160;987;496;491;38.7381;38.2681;39.2128
552411;1449;734;715;42.5173;41.0150;44.0594
505013;1310;648;662;42.4260;40.9336;43.8867
554103;203;108;95;41.2980;40.4722;42.2368
547077;1378;654;724;41.1139;40.1743;41.9627
505081;1796;895;901;43.5523;42.4821;44.6154
552267;351;162;189;41.9131;42.0370;41.8069
552151;1163;560;603;42.0150;40.8161;43.1285
505111;1622;839;783;44.2898;42.2414;46.4847
552194;205;101;104;40.4805;39.2129;41.7115
569054;150;80;70;45.4400;45.0625;45.8714
547018;605;322;283;42.3777;40.7733;44.2032
569771;179;86;93;42.0866;40.3488;43.6935
552429;212;110;102;40.2217;39.8000;40.6765
552011;795;407;388;39.9239;38.9668;40.9278
505161;3516;1698;1818;41.7130;40.6767;42.6810
505188;13440;6463;6977;43.1007;41.3739;44.7004
505218;1632;812;820;43.0306;41.6810;44.3671
505269;1291;644;647;42.9167;41.4115;44.4150
552089;609;296;313;41.7693;41.9088;41.6374
505293;1883;901;982;41.9572;40.8352;42.9868
505366;1701;853;848;41.4436;40.1612;42.7335
505501;1456;745;711;42.7878;41.1362;44.5183
505587;11335;5553;5782;44.1894;42.2542;46.0479
552364;435;215;220;42.3943;41.0767;43.6818
505609;3493;1761;1732;40.9878;39.5398;42.4602
505650;2981;1471;1510;39.0850;38.6951;39.4649
505668;1353;676;677;40.4313;38.3757;42.4838
552119;1384;686;698;42.4314;41.9125;42.9413
568961;435;225;210;43.8678;41.6600;46.2333
552399;238;114;124;41.2059;42.4737;40.0403
505862;454;227;227;41.7379;41.6410;41.8348
506761;259;122;137;42.4537;41.5574;43.2518
589268;1068;542;526;40.8670;40.0498;41.7091
589276;514;257;257;42.9377;41.5039;44.3716
589284;301;147;154;40.5831;41.3095;39.8896
589292;452;217;235;40.6925;37.7581;43.4021
589306;129;61;68;46.4845;47.3033;45.7500
589314;792;397;395;46.3182;44.7040;47.9405
589322;1526;751;775;41.1710;39.9874;42.3181
589331;214;114;100;45.5374;42.6842;48.7900
589349;414;221;193;42.4517;39.8303;45.4534
589357;302;145;157;46.8642;42.4724;50.9204
589365;534;269;265;42.4120;41.6301;43.2057
589381;1044;538;506;42.2864;41.0428;43.6087
589390;521;269;252;42.9088;40.1654;45.8373
589403;1314;650;664;42.6377;40.9723;44.2681
589420;536;265;271;42.8825;43.2736;42.5000
589438;346;179;167;39.1301;37.4274;40.9551
589446;824;417;407;38.5109;36.3969;40.6769
589454;539;271;268;42.1364;41.8137;42.4627
589462;516;267;249;42.8333;40.6835;45.1386
558419;1445;726;719;42.8696;42.2837;43.4611
589489;486;246;240;39.4794;37.0732;41.9458
589497;235;114;121;46.0957;46.2632;45.9380
549967;112;56;56;44.7232;40.6250;48.8214
589501;345;169;176;41.4072;40.2219;42.5455
589519;854;432;422;43.4567;41.8449;45.1066
589527;414;207;207;41.7005;41.5483;41.8527
589535;214;117;97;44.3178;42.9530;45.9639
589543;819;405;414;40.7076;39.4975;41.8913
543543;253;132;121;40.2826;39.2500;41.4091
589560;638;334;304;43.4138;41.7964;45.1908
589578;477;249;228;43.1625;41.2430;45.2588
589586;297;164;133;49.5337;48.0976;51.3045
589594;351;163;188;44.6168;43.9294;45.2128
589608;859;420;439;40.1112;39.5262;40.6708
589616;274;150;124;42.6277;40.1200;45.6613
589624;2784;1367;1417;43.8843;42.6763;45.0498
589632;2900;1409;1491;42.6103;41.4092;43.7455
589641;284;148;136;45.2535;43.7365;46.9044
589659;1706;866;840;38.9414;38.1732;39.7333
589667;586;289;297;42.1502;40.1540;44.0926
589675;584;288;296;44.5582;43.7569;45.3378
589683;376;196;180;42.8670;41.3163;44.5556
589691;710;373;337;45.5310;44.3606;46.8264
589705;538;268;270;46.8978;44.5075;49.2704
589713;366;184;182;44.2951;43.0707;45.5330
589721;531;275;256;41.1968;40.6491;41.7852
589730;1580;786;794;44.7057;43.6730;45.7280
589748;668;345;323;44.5464;44.1812;44.9365
589756;1974;971;1003;43.5010;41.7183;45.2268
589764;1475;767;708;40.2302;39.9224;40.5636
589772;339;156;183;42.6239;41.5962;43.5000
589799;282;134;148;40.4574;38.4925;42.2365
589802;466;233;233;42.7682;41.0923;44.4442
589811;193;99;94;38.8212;36.9242;40.8191
589829;1809;868;941;39.8201;39.0933;40.4904
589837;359;195;164;43.4805;41.4538;45.8902
589845;1290;635;655;42.1302;41.1945;43.0374
589853;279;148;131;43.9194;40.1689;48.1565
557196;260;125;135;44.3423;44.8840;43.8407
589870;742;379;363;40.5997;39.3575;41.8967
589888;730;357;373;40.7082;39.0042;42.3391
589896;2311;1136;1175;44.0418;41.9489;46.0651
549983;148;74;74;44.0541;42.1486;45.9595
589250;43651;20494;23157;43.8334;41.8761;45.5656
589918;306;165;141;40.7190;38.4394;43.3865
589926;1028;506;522;40.9368;39.8340;42.0057
589934;1272;629;643;43.1840;41.3617;44.9666
589942;1075;559;516;42.5893;39.8578;45.5484
589951;205;94;111;41.0415;40.3723;41.6081
589969;93;47;46;46.0161;46.4574;45.5652
589977;626;317;309;43.8658;42.6514;45.1117
506770;522;261;261;41.7912;40.5345;43.0479
589993;259;133;126;43.6776;42.2519;45.1825
590002;330;169;161;44.2000;44.0503;44.3571
590011;580;287;293;41.1966;39.9251;42.4420
590029;1618;842;776;43.0383;41.9169;44.2552
590045;87;51;36;41.7874;39.4804;45.0556
590053;543;267;276;43.2587;43.0131;43.4964
590061;162;76;86;43.3889;41.4737;45.0814
590070;433;210;223;45.1351;43.6429;46.5404
590088;586;323;263;44.6536;43.1378;46.5152
590096;255;132;123;45.4725;43.6818;47.3943
590100;484;249;235;41.8760;39.8855;43.9851
590118;275;133;142;45.5836;42.2895;48.6690
590126;1395;681;714;40.7652;38.8568;42.5854
590134;587;356;231;43.5784;44.5365;42.1017
590142;553;271;282;40.9430;41.2380;40.6596
544710;118;57;61;47.5085;45.6579;49.2377
590151;183;89;94;44.2705;42.7584;45.7021
590177;601;303;298;43.2088;42.0281;44.4094
590185;1740;863;877;40.4816;39.6935;41.2571
590193;622;304;318;39.7186;38.9342;40.4686
590207;560;272;288;39.4625;39.5074;39.4201
590215;486;240;246;41.4486;40.1958;42.6707
590223;368;182;186;40.9484;42.3407;39.5860
590240;555;283;272;42.4676;40.7191;44.2868
512231;1838;942;896;40.3819;39.3461;41.4710
512281;677;331;346;44.1455;43.7236;44.5491
512401;194;93;101;41.9433;38.2419;45.3515
569178;313;157;156;45.9217;45.1561;46.6923
512532;977;488;489;43.0271;41.0533;44.9969
512800;1940;972;968;43.3351;41.2068;45.4721
512826;378;204;174;43.2249;40.9657;45.8736
512877;406;208;198;41.0665;40.0865;42.0960
569135;304;154;150;41.2599;40.2468;42.3000
512982;538;274;264;41.4535;40.0036;42.9583
552771;329;167;162;45.7432;42.9970;48.5741
513059;125;61;64;38.8520;37.2541;40.3750
513067;774;381;393;42.7687;40.5919;44.8791
513105;224;113;111;43.1116;41.4823;44.7703
569259;246;121;125;46.3984;44.7810;47.9640
552984;66;27;39;39.2273;44.2778;35.7308
513199;1227;636;591;42.0037;40.1384;44.0110
513211;559;287;272;41.8739;41.6394;42.1213
513229;1500;770;730;43.5420;42.6883;44.4425
569194;163;75;88;42.0031;39.9267;43.7727
569267;235;114;121;41.9894;41.1404;42.7893
513491;1697;845;852;41.3922;39.9379;42.8345
569275;205;107;98;46.3000;45.1075;47.6020
552968;155;71;84;45.2290;46.3732;44.2619
569542;425;221;204;45.9094;42.9615;49.1029
513636;309;154;155;44.1796;43.8571;44.5000
513733;310;150;160;41.0806;39.8267;42.2563
513750;17999;8727;9272;43.3904;41.5749;45.0992
513768;1759;848;911;42.3135;41.2689;43.2859
556998;664;331;333;43.0030;41.6208;44.3769
513873;473;232;241;43.8023;41.2888;46.2220
569283;146;63;83;40.4452;41.5794;39.5843
514047;250;127;123;41.8600;40.1850;43.5894
514055;6078;2995;3083;42.6565;40.8890;44.3735
514152;1153;555;598;42.6258;40.1523;44.9214
569143;434;216;218;44.0438;44.4954;43.5963
552780;421;207;214;41.7019;39.0652;44.2523
514446;201;100;101;44.6642;43.1000;46.2129
514471;540;279;261;42.0759;40.7366;43.5077
514497;321;163;158;43.8364;42.4755;45.2405
514527;63;30;33;37.5000;30.4000;43.9545
514705;7982;3923;4059;42.9222;41.3733;44.4192
514772;275;133;142;43.8673;42.1316;45.4930
514802;261;128;133;41.6456;40.3203;42.9211
515191;739;395;344;42.5474;41.4013;43.8634
500151;127;74;53;41.3189;38.5541;45.1792
515329;373;192;181;40.7681;40.9271;40.5994
552909;695;352;343;39.6640;38.3949;40.9665
515418;437;209;228;42.2391;41.6100;42.8158
515477;294;160;134;42.6769;41.1438;44.5075
552810;163;83;80;42.4325;39.1747;45.8125
515787;195;86;109;42.9103;43.2442;42.6468
515825;116;56;60;42.8362;38.2500;47.1167
552844;500;257;243;42.3020;41.4961;43.1543
516201;818;420;398;41.2298;40.3833;42.1231
553000;335;173;162;42.8463;41.5462;44.2346
516350;86;40;46;45.4186;43.1250;47.4130
516619;1285;636;649;40.6759;40.3601;40.9854
516635;399;204;195;40.6053;40.0147;41.2231
516686;510;262;248;41.3294;40.2061;42.5161
516694;719;371;348;43.9145;41.2520;46.7529
516864;210;105;105;42.9619;41.5952;44.3286
516899;500;254;246;41.8740;40.6614;43.1260
516911;275;136;139;38.6745;36.2206;41.0755
517101;1189;608;581;44.4092;42.8799;46.0095
517151;795;389;406;44.4962;44.9293;44.0813
517208;155;82;73;39.1323;38.8415;39.4589
511382;42871;20784;22087;44.9123;42.9170;46.7899
517224;276;145;131;42.9638;41.7069;44.3550
517275;163;77;86;41.4877;43.8766;39.3488
517321;203;80;123;59.0320;54.2875;62.1179
517437;155;84;71;40.9968;40.3690;41.7394
517445;182;90;92;42.0440;41.5778;42.5000
517534;1140;575;565;42.4202;41.5661;43.2894
517569;281;138;143;41.6851;40.8696;42.4720
517585;407;209;198;40.6990;39.5670;41.8939
517607;1523;717;806;42.3516;39.8180;44.6055
517615;254;126;128;40.1811;38.8333;41.5078
517666;474;241;233;43.5802;42.2635;44.9421
517747;634;291;343;38.7461;38.0395;39.3455
517844;584;308;276;41.6216;39.6558;43.8152
517836;156;84;72;45.2821;42.8452;48.1250
517887;619;312;307;40.9233;40.4391;41.4153
552887;270;134;136;41.4926;42.9254;40.0809
517909;843;411;432;42.0302;40.9088;43.0972
518026;328;162;166;45.8171;44.6358;46.9699
552950;218;110;108;43.4266;42.9182;43.9444
570061;281;140;141;42.0160;41.4357;42.5922
519031;380;187;193;41.3053;40.6818;41.9093
519146;2468;1196;1272;43.2143;41.9022;44.4481
519651;2035;1002;1033;44.1993;42.7465;45.6084
520047;435;206;229;44.3943;43.0922;45.5655
552836;220;120;100;42.3955;41.3750;43.6200
570079;846;425;421;44.0579;42.8271;45.3005
552879;522;271;251;46.9617;45.7251;48.2968
520306;559;296;263;41.8810;41.5946;42.2034
520420;894;447;447;41.8680;39.5738;44.1622
552755;207;106;101;45.4034;43.6887;47.2030
547433;690;355;335;44.8261;42.3310;47.4701
521531;849;422;427;42.9170;41.9692;43.8536
547450;280;137;143;41.8821;43.1934;40.6259
547514;180;79;101;43.4056;42.2342;44.3218
522775;245;123;122;43.1449;43.8415;42.4426
523453;238;119;119;39.7437;38.6261;40.8613
523640;553;289;264;44.5651;43.4723;45.7614
525588;3062;1526;1536;43.5147;42.3139;44.7077
525804;1304;655;649;43.3221;42.6618;43.9884
525880;513;258;255;41.0634;38.6473;43.5078
525979;769;378;391;42.7497;41.1958;44.2519
526169;278;142;136;42.2050;42.7887;41.5956
569437;627;334;293;41.9561;40.7904;43.2850
530727;663;337;326;41.8846;40.9481;42.8528
532894;387;201;186;44.9289;44.5597;45.3280
533688;493;236;257;44.0903;43.6992;44.4494
553379;1372;686;686;43.1020;42.2886;43.9155
570141;353;173;180;41.1261;41.7832;40.4944
534927;1081;518;563;40.9801;39.6776;42.1785
535532;3104;1550;1554;43.4546;41.5787;45.3256
535770;342;181;161;44.6316;44.0304;45.3075
535885;440;210;230;38.9977;39.0048;38.9913
553387;175;90;85;38.8200;38.5000;39.1588
536091;836;426;410;42.3361;41.5704;43.1317
553221;649;328;321;40.7496;40.0366;41.4782
536113;185;95;90;45.3000;46.6579;43.8667
569305;555;264;291;42.6027;42.4621;42.7302
553344;222;124;98;40.7162;38.0242;44.1224
553212;42;19;23;44.3095;46.1842;42.7609
536288;687;340;347;44.2700;42.8882;45.6239
536393;662;327;335;40.4169;40.1422;40.6851
536521;1163;613;550;43.0082;41.5212;44.6655
536571;514;256;258;45.5837;45.0898;46.0736
536687;621;293;328;41.6256;41.6536;41.6006
536733;721;363;358;42.6928;41.0758;44.3324
553247;280;159;121;39.9714;39.1478;41.0537
536814;313;160;153;39.7173;37.6500;41.8791
569372;172;92;80;42.2500;41.7826;42.7875
537284;651;333;318;42.0238;41.3168;42.7642
537713;1255;626;629;41.8602;40.0272;43.6844
539961;3267;1654;1613;43.1100;41.1505;45.1193
540161;395;204;191;40.6139;38.9167;42.4267
540196;2970;1445;1525;44.4566;42.4564;46.3518
540226;1525;762;763;47.2515;45.8478;48.6533
540234;854;439;415;42.3501;40.9510;43.8301
540331;526;273;253;43.0342;42.6502;43.4486
540366;395;211;184;39.7658;39.9882;39.5109
569381;376;192;184;43.7872;43.6354;43.9457
540471;9234;4580;4654;43.0420;41.1491;44.9048
540480;1318;660;658;42.4090;41.3242;43.4970
553476;662;321;341;42.4215;42.1604;42.6672
540501;3677;1866;1811;38.2642;37.1056;39.4580
540510;1047;539;508;42.7569;41.7096;43.8681
540544;1277;652;625;45.5987;43.3773;47.9160
540595;336;181;155;42.5774;39.2293;46.4871
540609;653;330;323;40.3025;39.1303;41.5000
500020;1220;610;610;43.3139;41.7951;44.8328
540650;714;352;362;41.0952;40.6790;41.5000
540731;206;110;96;43.2136;42.9273;43.5417
540773;3019;1452;1567;43.9432;42.9208;44.8906
553352;313;148;165;43.2157;41.1081;45.1061
540854;512;254;258;41.7188;42.3150;41.1318
540862;3291;1641;1650;41.8950;40.9180;42.8667
553395;184;92;92;42.1413;42.4239;41.8587
540871;625;324;301;42.6472;40.9938;44.4269
540919;834;402;432;39.9544;39.3607;40.5069
540978;2512;1275;1237;42.1218;41.0788;43.1968
540986;1146;572;574;44.6466;42.5647;46.7213
541079;1712;871;841;43.6974;42.3944;45.0470
570281;135;70;65;43.3593;41.8571;44.9769
541109;1152;585;567;41.9861;39.4316;44.6217
541125;418;203;215;44.2416;44.3916;44.1000
570117;42;21;21;41.1905;39.3095;43.0714
541168;2022;1034;988;42.5326;41.0039;44.1326
523704;25836;12162;13674;44.6134;42.4667;46.5227
553336;385;197;188;39.9935;38.9365;41.1011
541222;1166;585;581;41.9949;40.0556;43.9475
541265;2568;1259;1309;46.3361;45.3721;47.2632
554146;203;101;102;41.7266;43.9950;39.4804
553191;70;40;30;44.8429;42.9000;47.4333
569445;2350;1142;1208;41.8315;40.8932;42.7185
570095;249;122;127;39.0944;39.3770;38.8228
541354;13456;6479;6977;43.8289;41.9816;45.5444
570338;217;108;109;41.5553;41.6481;41.4633
541478;857;418;439;41.3681;40.8947;41.8189
588300;478;242;236;44.0209;43.0620;45.0042
588326;514;250;264;41.0272;40.9680;41.0833
542318;194;98;96;44.5773;41.2041;48.0208
549690;199;96;103;41.1281;41.9792;40.3350
588377;372;191;181;43.7823;40.9503;46.7707
588385;949;476;473;42.2671;41.6954;42.8425
588393;8144;3898;4246;44.3784;42.5839;46.0259
588407;181;90;91;46.4779;43.9667;48.9615
588431;429;219;210;43.1783;41.3950;45.0381
588458;11579;5547;6032;44.1267;42.6781;45.4589
542342;79;45;34;39.6392;35.3444;45.3235
588474;271;149;122;40.0646;39.1779;41.1475
588482;165;92;73;41.5485;38.8152;44.9932
588491;6762;3329;3433;43.7171;42.2828;45.1079
588504;361;185;176;43.0651;40.2081;46.0682
588512;4853;2362;2491;43.2849;41.4797;44.9966
506737;1614;779;835;44.9343;43.3023;46.4569
588547;243;124;119;44.9856;41.7984;48.3067
588555;401;206;195;41.6172;40.3010;43.0077
588563;303;160;143;40.4340;41.3375;39.4231
587354;251;129;122;41.0697;39.6473;42.5738
588598;281;135;146;45.0943;44.8630;45.3082
588601;2751;1358;1393;44.4124;42.0464;46.7190
588521;621;326;295;41.9670;41.6503;42.3169
588610;1015;526;489;43.2862;41.8802;44.7986
588296;28620;13592;15028;44.2361;41.9437;46.3094
588628;89;45;44;40.4101;40.5222;40.2955
588636;255;133;122;42.2451;40.4624;44.1885
588644;2232;1145;1087;43.5950;41.8546;45.4282
588652;486;234;252;41.1667;41.0342;41.2897
588661;409;215;194;40.5318;39.9605;41.1649
588695;463;232;231;40.3639;37.8750;42.8636
588709;925;480;445;41.3822;39.8542;43.0303
588717;464;227;237;41.5733;40.1740;42.9135
588725;495;237;258;41.7949;40.9262;42.5930
588733;594;300;294;41.7626;40.5733;42.9762
588741;796;407;389;40.9322;39.1339;42.8136
588750;661;322;339;39.2837;38.2360;40.2788
588768;2942;1443;1499;41.6825;40.1611;43.1471
553905;279;138;141;43.8548;41.8696;45.7979
588784;347;174;173;43.7133;42.8563;44.5751
588806;233;118;115;42.5858;40.4407;44.7870
588814;432;228;204;40.8727;38.7982;43.1912
588822;458;241;217;40.7511;39.8527;41.7488
588831;229;115;114;42.3341;40.5087;44.1754
588849;879;425;454;45.2440;42.2200;48.0749
588865;707;347;360;43.4095;42.2089;44.5667
588873;475;247;228;44.0242;42.3826;45.8026
587397;254;125;129;45.6654;41.4520;49.7481
588890;725;362;363;42.1910;40.5470;43.8306
588903;1230;608;622;41.5976;40.0115;43.1479
549720;987;501;486;41.4483;40.5220;42.4033
588920;533;284;249;42.4381;40.3873;44.7771
588938;1154;579;575;40.5000;40.2358;40.7661
588946;673;332;341;43.0988;41.5542;44.6026
588954;684;342;342;44.1155;42.1023;46.1287
588962;552;296;256;45.6884;43.5777;48.1289
588971;602;289;313;41.8671;40.7837;42.8674
588989;388;207;181;42.9072;43.1763;42.5994
588997;658;318;340;40.9666;38.6541;43.1294
589004;373;191;182;41.7064;41.4738;41.9505
589039;598;311;287;46.4147;45.1592;47.7753
589047;255;135;120;41.0373;39.7000;42.5417
589055;154;77;77;42.8442;42.0584;43.6299
557188;350;176;174;40.4657;39.0511;41.8966
589080;449;229;220;43.1370;43.6354;42.6182
589098;273;134;139;42.4780;40.1642;44.7086
589110;188;88;100;42.5851;42.0795;43.0300
589128;414;198;216;43.3333;44.3889;42.3657
589136;396;202;194;45.1818;43.1782;47.2680
542393;194;98;96;47.2887;46.2245;48.3750
589152;322;168;154;42.8075;42.9048;42.7013
589161;717;330;387;44.0244;42.6606;45.1873
587257;139;73;66;43.8525;42.8836;44.9242
589187;1462;734;728;43.4952;42.5899;44.4080
589195;2125;1071;1054;41.4449;40.5570;42.3472
589217;626;316;310;40.5895;39.4968;41.7032
589225;592;292;300;42.2584;41.4692;43.0267
589233;796;398;398;40.9309;39.3090;42.5528
592013;1825;881;944;42.8978;42.4137;43.3496
592021;2106;1056;1050;42.4582;41.3684;43.5543
592030;1925;968;957;40.2210;39.2944;41.1583
592048;4382;2151;2231;43.7768;42.1420;45.3530
592064;2162;1082;1080;44.0476;42.0000;46.0991
592056;829;420;409;42.5048;41.2143;43.8301
592072;837;415;422;43.4438;41.3771;45.4763
592081;1683;848;835;42.1435;40.6132;43.6976
592099;1003;523;480;42.9357;41.9570;44.0021
592102;2421;1164;1257;46.9263;44.3213;49.3385
592111;806;399;407;44.3213;43.3772;45.2469
592137;384;186;198;43.9635;42.1613;45.6566
592145;2977;1483;1494;42.9558;41.0381;44.8594
592153;498;258;240;42.8032;40.1938;45.6083
592170;4372;2161;2211;43.2338;41.9674;44.4715
592188;828;419;409;44.2379;41.9654;46.5660
592196;44;23;21;34.4545;37.0217;31.6429
550736;214;114;100;45.0093;41.6842;48.8000
592200;1013;528;485;42.0459;39.8826;44.4010
592218;964;496;468;42.8205;41.5242;44.1944
592226;1827;898;929;41.4672;40.7706;42.1405
592234;458;239;219;43.1223;41.6632;44.7146
592269;1097;561;536;42.4790;40.4947;44.5560
592277;561;273;288;42.8298;42.1410;43.4826
592285;935;469;466;44.5984;42.7303;46.4785
592293;915;453;462;42.6574;40.7141;44.5628
592307;407;204;203;42.6327;41.9755;43.2931
592323;977;481;496;41.3260;41.1133;41.5323
550744;5579;2685;2894;42.7787;41.3123;44.1393
592340;229;123;106;41.6921;42.3943;40.8774
592366;462;241;221;40.8009;39.5456;42.1697
592382;1190;600;590;41.2479;40.3950;42.1153
592391;734;348;386;41.4632;39.9425;42.8342
592404;817;403;414;43.4951;42.3040;44.6546
592412;1590;785;805;42.3075;41.0376;43.5460
592421;733;360;373;46.2408;43.7861;48.6099
592439;3349;1657;1692;42.7036;41.4813;43.9007
592447;764;389;375;40.6898;38.5257;42.9347
592455;1480;732;748;43.8534;41.7678;45.8944
592463;3488;1731;1757;43.1671;41.4896;44.8199
592471;882;444;438;43.5340;40.4595;46.6507
592480;702;356;346;43.0342;41.7275;44.3786
592498;919;460;459;41.0310;39.4543;42.6111
592501;886;438;448;40.9797;39.9566;41.9799
592510;1994;985;1009;42.9448;42.0005;43.8667
592528;1029;511;518;44.0743;41.8327;46.2857
592536;1036;517;519;41.6438;41.0261;42.2592
592552;427;201;226;46.4133;44.1368;48.4381
592561;396;207;189;44.0177;42.4227;45.7646
592579;666;325;341;44.4444;42.1585;46.6232
592587;122;67;55;44.5738;46.2015;42.5909
550752;6661;3251;3410;43.5209;42.1380;44.8393
592609;900;477;423;44.1711;43.3847;45.0579
592617;3474;1712;1762;43.6788;42.2973;45.0210
592625;419;217;202;45.5883;42.9608;48.4109
592633;158;86;72;50.3354;49.4884;51.3472
592641;1153;591;562;41.3482;39.6117;43.1744
592650;620;317;303;42.6097;41.3991;43.8762
592668;230;119;111;46.5478;42.6429;50.7342
592676;1649;835;814;43.4102;41.1587;45.7199
592692;1645;835;810;42.1091;40.5934;43.6716
592706;1153;565;588;42.3239;42.0062;42.6293
592714;253;122;131;42.5632;40.2951;44.6756
592722;1148;579;569;41.5357;40.2876;42.8058
592005;25247;11960;13287;44.3432;42.2564;46.2216
592731;16441;8049;8392;44.0837;42.3042;45.7905
592749;4217;2057;2160;44.4251;42.5768;46.1852
592757;252;130;122;40.2421;41.2308;39.1885
592773;197;115;82;42.9569;41.5087;44.9878
592781;438;216;222;42.7808;41.6250;43.9054
592790;1170;559;611;45.6376;44.0546;47.0859
592803;550;284;266;44.9673;43.4014;46.6391
592820;2999;1492;1507;43.3283;41.8117;44.8298
592838;148;90;58;40.8851;40.2111;41.9310
592846;1041;531;510;43.1897;42.2175;44.2020
592854;322;166;156;42.5342;43.9518;41.0256
592862;1644;806;838;42.7117;41.6179;43.7637
592871;173;88;85;43.9798;45.1818;42.7353
541648;986;512;474;40.0193;39.2559;40.8439
541711;1020;503;517;42.8069;41.7087;43.8752
541800;1881;947;934;43.4048;41.7925;45.0396
542644;1541;800;741;42.0678;41.1525;43.0560
542679;2428;1216;1212;41.5745;39.7385;43.4167
542687;2455;1231;1224;44.2234;42.7104;45.7451
542725;1370;697;673;40.9015;39.5760;42.2741
542750;2224;1088;1136;41.2716;40.6691;41.8486
542768;2390;1185;1205;41.7301;40.3734;43.0643
542784;2214;1115;1099;41.8257;40.7619;42.9049
542814;2030;995;1035;42.9099;41.1201;44.6304
542831;765;387;378;41.7340;40.8798;42.6085
542865;2056;1033;1023;42.8906;41.2822;44.5147
570346;754;365;389;42.7016;40.7795;44.5051
542903;860;437;423;40.1337;38.4657;41.8570
542911;2529;1288;1241;43.9986;41.1592;46.9456
542946;1037;557;480;41.8944;38.9452;45.3167
542989;2706;1372;1334;40.8947;39.0707;42.7706
542997;438;223;215;41.0731;37.7691;44.5000
500062;2019;1003;1016;42.4425;40.6805;44.1821
543021;631;329;302;43.2005;40.8495;45.7616
543098;849;417;432;40.7532;39.5911;41.8750
544264;661;326;335;43.1263;42.2270;44.0015
544302;2046;1000;1046;41.5689;40.0940;42.9790
556866;794;400;394;41.8778;41.0650;42.7030
544370;1819;921;898;40.4544;38.8192;42.1314
544396;1501;727;774;41.5486;40.8026;42.2494
544418;800;389;411;39.9638;38.8882;40.9818
544434;618;303;315;42.7265;42.6914;42.7603
544469;291;147;144;47.3454;44.5476;50.2014
544507;791;408;383;39.8085;38.1422;41.5836
544566;2612;1349;1263;43.3560;41.6505;45.1778
544574;495;259;236;40.8313;38.8591;42.9958
569496;265;144;121;40.2887;40.2361;40.3512
544621;579;285;294;39.6192;37.9386;41.2483
500071;1753;890;863;43.0722;41.3865;44.8105
544655;594;287;307;41.9192;40.3223;43.4121
544671;523;267;256;42.1386;40.1142;44.2500
544698;1764;872;892;42.4456;41.6124;43.2601
544728;647;339;308;43.3439;41.7360;45.1136
544787;1847;921;926;41.3690;39.8105;42.9190
544841;16398;7927;8471;44.4513;42.3720;46.3972
544850;913;458;455;42.5318;41.2620;43.8099
544906;302;157;145;43.6258;41.2516;46.1966
544914;571;291;280;42.0184;40.0670;44.0464
544922;855;439;416;42.8567;40.9305;44.8894
544931;499;267;232;42.4599;40.4625;44.7586
570371;621;301;320;42.4179;41.5930;43.1938
544949;2245;1114;1131;42.7820;42.3761;43.1817
544990;1440;722;718;41.0535;40.0956;42.0167
553026;436;204;232;44.3853;43.2549;45.3793
545058;22306;10808;11498;43.3298;41.4214;45.1237
545112;307;153;154;39.1091;37.8595;40.3506
545147;493;252;241;42.6744;42.7024;42.6452
545163;2370;1183;1187;45.0574;42.8094;47.2978
545198;1762;873;889;41.9285;40.7050;43.1299
545210;1093;531;562;41.3820;39.9162;42.7669
541630;25974;12417;13557;43.9682;41.8585;45.9005
545236;3043;1518;1525;41.8112;40.1963;43.4187
545244;576;270;306;44.0191;43.1148;44.8170
545252;5547;2773;2774;42.2498;41.0781;43.4211
588318;317;156;161;43.3044;43.3974;43.2143
585076;692;350;342;42.4942;40.7229;44.3070
557102;370;188;182;43.9432;42.8777;45.0440
585092;774;372;402;42.4134;41.3952;43.3557
585106;766;397;369;42.2507;40.3640;44.2805
585114;5528;2805;2723;42.7571;40.7474;44.8272
538744;1337;662;675;42.0183;41.5136;42.5133
585131;514;256;258;40.5233;40.0391;41.0039
585149;693;339;354;42.6732;42.7153;42.6328
585157;210;101;109;42.5619;42.9653;42.1881
585165;249;125;124;46.5361;44.4200;48.6694
585173;652;312;340;40.1227;40.1506;40.0971
585181;582;294;288;39.5670;38.9252;40.2222
585190;431;225;206;40.9200;39.7000;42.2524
585203;354;193;161;42.0141;41.6658;42.4317
585211;3684;1793;1891;43.3021;42.0984;44.4434
585220;1956;996;960;40.5435;40.0201;41.0865
585238;82;43;39;44.7195;45.4302;43.9359
585246;594;288;306;40.5236;40.1910;40.8366
585254;545;289;256;38.1110;37.0779;39.2773
585262;459;220;239;44.3410;44.7182;43.9937
585271;546;269;277;43.2784;40.7268;45.7563
585289;1281;649;632;41.6827;41.2365;42.1408
585301;967;485;482;41.5072;40.3990;42.6224
585319;273;141;132;42.5549;41.4220;43.7652
585327;282;134;148;42.7624;41.3657;44.0270
587052;241;126;115;44.2095;41.9921;46.6391
585343;937;460;477;39.8255;38.0326;41.5545
592251;147;81;66;45.9762;44.4877;47.8030
549436;316;161;155;44.0411;41.0404;47.1581
586960;184;97;87;38.0598;33.8608;42.7414
573434;890;455;435;39.1775;37.4692;40.9644
549550;274;135;139;41.1642;39.2333;43.0396
549622;861;431;430;42.3978;40.8968;43.9023
586871;363;184;179;40.7948;38.5707;43.0810
585432;472;218;254;48.9852;45.2110;52.2244
585441;716;354;362;41.8841;41.3955;42.3619
585459;5059;2466;2593;45.2276;42.7903;47.5455
585467;1756;854;902;43.1771;40.0023;46.1829
557145;460;236;224;41.5783;39.3814;43.8929
585483;417;201;216;43.9436;43.3507;44.4954
585491;653;331;322;39.5536;36.4819;42.7112
585505;636;316;320;41.7484;41.9620;41.5375
585513;7171;3525;3646;44.1929;42.2379;46.0831
585521;726;358;368;40.4807;40.1341;40.8179
585530;1373;715;658;38.7309;37.9014;39.6322
585548;688;351;337;40.7122;39.3490;42.1320
585556;463;219;244;41.6447;39.2808;43.7664
549444;396;200;196;41.0884;39.8950;42.3061
557170;409;212;197;43.2702;41.4151;45.2665
585599;17879;8761;9118;44.6674;42.5289;46.7222
556874;340;160;180;43.0559;43.7688;42.4222
534811;201;98;103;43.1119;39.5102;46.5388
585611;336;183;153;47.0327;45.2760;49.1340
549461;898;437;461;42.2071;39.9027;44.3915
549533;761;406;355;41.3633;39.5739;43.4099
549401;1261;614;647;42.6634;41.6580;43.6175
585661;785;389;396;43.0274;41.9730;44.0631
585670;845;416;429;39.3260;38.2957;40.3252
556980;601;297;304;44.7429;44.0421;45.4276
586919;253;139;114;44.9585;42.0540;48.5000
585726;764;375;389;40.4411;39.6147;41.2378
585734;675;329;346;44.4467;42.7584;46.0520
585751;6386;3122;3264;44.3722;42.5048;46.1584
585769;577;278;299;41.9783;39.6043;44.1856
585777;2968;1465;1503;41.1233;39.8242;42.3896
585793;1699;845;854;42.7337;42.2396;43.2225
585807;485;248;237;44.4608;43.3266;45.6477
585815;256;115;141;42.9492;42.6478;43.1950
585831;2176;1092;1084;43.3819;41.9817;44.7924
549649;1360;704;656;41.6478;40.9545;42.3918
535184;317;165;152;40.8091;39.0394;42.7303
585858;2459;1238;1221;42.7700;41.1333;44.4296
585866;1153;597;556;43.1262;41.8819;44.4622
585874;308;157;151;40.9416;38.6210;43.3543
585882;1194;607;587;42.3317;41.0750;43.6312
585891;4946;2441;2505;42.1913;40.2632;44.0701
585912;756;363;393;41.3624;40.5661;42.0980
585921;848;427;421;41.0778;39.8607;42.3124
585939;4857;2362;2495;41.7802;40.8975;42.6158
586994;227;116;111;42.9670;40.2931;45.7613
585955;1472;714;758;42.0279;40.7521;43.2296
585963;416;218;198;43.3125;41.3440;45.4798
585971;1134;557;577;41.6085;39.4749;43.6681
585980;845;435;410;38.8929;37.9460;39.8976
585998;1479;764;715;40.9604;40.0013;41.9853
585068;74935;35936;38999;44.1518;42.2351;45.9179
500011;1869;933;936;45.1576;43.0659;47.2425
586013;1185;598;587;41.0975;40.5886;41.6158
551929;371;186;185;42.1253;42.1237;42.1270
597198;224;118;106;44.9107;43.9831;45.9434
597201;367;200;167;41.9578;40.8150;43.3263
597210;1374;702;672;41.8115;40.7550;42.9152
597180;16138;7763;8375;42.1747;40.2788;43.9320
597228;3111;1579;1532;44.5203;42.3436;46.7637
569607;162;73;89;41.2099;43.0205;39.7247
552003;315;164;151;40.6111;39.6951;41.6060
597252;420;220;200;43.4524;42.5000;44.5000
551864;299;154;145;40.7107;39.8117;41.6655
551708;90;44;46;44.6444;42.9318;46.2826
597287;385;194;191;43.2506;42.4278;44.0864
597317;1304;637;667;42.4785;41.6962;43.2256
597325;322;160;162;45.5839;46.6813;44.5000
551872;185;92;93;38.6405;36.3804;40.8763
597341;718;386;332;44.6643;43.8731;45.5843
597350;2249;1130;1119;42.1292;40.9044;43.3660
597368;836;420;416;43.2165;41.7595;44.6875
551805;343;177;166;41.0569;40.0254;42.1566
597392;616;318;298;43.2289;43.1761;43.2852
597431;284;146;138;49.6127;47.7329;51.6014
597449;1213;617;596;44.1521;42.5600;45.8003
597457;281;159;122;42.2224;41.6698;42.9426
597473;165;87;78;46.0697;43.8793;48.5128
597481;1017;518;499;42.6613;40.4170;44.9910
597511;346;186;160;43.2803;40.9140;46.0313
597520;23257;11185;12072;43.9598;42.0658;45.7146
597538;258;130;128;44.7442;44.4615;45.0313
597546;419;210;209;45.1730;43.6571;46.6962
597554;1002;509;493;41.4850;39.6473;43.3824
597571;456;229;227;45.7654;45.8537;45.6762
597589;515;252;263;41.7621;40.7143;42.7662
551996;287;151;136;46.1167;43.5464;48.9706
597601;636;328;308;46.6871;45.8415;47.5877
551902;133;70;63;45.9812;47.8286;43.9286
597635;3499;1722;1777;44.3451;42.3473;46.2811
551724;400;219;181;40.4950;39.2032;42.0580
569526;385;198;187;39.2195;39.2222;39.2166
551732;566;298;268;41.5353;41.1577;41.9552
546950;54;27;27;40.0556;37.5000;42.6111
569551;378;189;189;40.2672;40.8651;39.6693
569577;424;226;198;39.7877;38.7876;40.9293
597716;1125;568;557;38.1338;36.3468;39.9560
551848;139;65;74;44.6511;44.0077;45.2162
597724;518;265;253;42.6062;41.8208;43.4289
597741;210;109;101;45.9762;45.0321;46.9950
551945;379;203;176;40.5765;38.9680;42.4318
597775;148;76;72;45.8041;44.3289;47.3611
597783;8181;4050;4131;44.2074;42.1573;46.2173
597791;620;325;295;44.4548;43.9862;44.9712
551881;211;104;107;37.5995;34.8942;40.2290
597813;525;291;234;41.5457;40.2457;43.1624
551911;486;244;242;45.4156;45.2336;45.5992
551813;194;98;96;44.0515;43.5000;44.6146
551767;919;472;447;41.8221;41.4661;42.1980
597872;1406;718;688;42.7575;41.2799;44.2994
597881;540;261;279;39.7759;38.5192;40.9516
597899;541;275;266;44.1728;43.8309;44.5263
597911;908;478;430;43.3855;43.0063;43.8070
551821;231;122;109;47.9892;47.4426;48.6009
597937;998;504;494;42.6313;41.3214;43.9676
597945;470;248;222;40.4447;38.7339;42.3559
551783;239;128;111;40.7134;39.6016;41.9955
551694;341;183;158;44.4677;42.7568;46.4494
597961;4995;2460;2535;45.7751;44.1516;47.3505
597970;300;157;143;45.2700;42.8885;47.8846
597988;1169;590;579;42.1929;41.1814;43.2237
598011;3924;1969;1955;42.4358;40.7103;44.1737
598020;281;147;134;46.2295;45.1122;47.4552
511633;477;244;233;38.9361;38.4918;39.4013
598038;4101;2001;2100;42.2315;40.8518;43.5462
598046;917;474;443;40.4935;38.1055;43.0485
511935;1384;698;686;38.0123;36.2908;39.7638
598062;5356;2606;2750;42.4080;40.7421;43.9865
598071;2836;1415;1421;43.6107;42.2915;44.9243
598089;3205;1600;1605;42.9256;41.7994;44.0483
552542;1285;621;664;40.8907;40.7045;41.0648
598101;1382;673;709;41.4255;40.7660;42.0515
511951;922;459;463;41.4035;41.6460;41.1631
552607;354;183;171;40.0452;37.8169;42.4298
598135;2449;1202;1247;42.3938;41.1531;43.5898
598003;55557;27245;28312;43.0262;41.3667;44.6231
598143;9922;4759;5163;43.6315;42.0442;45.0946
598160;1464;717;747;44.7350;42.6646;46.7222
512192;924;469;455;38.0606;37.2633;38.8824
511986;381;212;169;42.7073;39.6038;46.6006
552631;642;334;308;38.7321;37.8862;39.6494
512176;1879;919;960;40.9162;39.1235;42.6323
598232;252;136;116;43.6786;43.5368;43.8448
598691;2080;1044;1036;42.8207;41.4914;44.1602
598259;5474;2655;2819;42.7273;40.7384;44.6004
507423;1930;954;976;41.9715;41.0115;42.9098
598275;321;160;161;41.7897;40.5938;42.9783
507237;1420;708;712;42.2106;41.2429;43.1728
507458;372;194;178;42.1989;41.8351;42.5955
598321;3051;1519;1532;41.1526;40.1623;42.1345
549673;682;340;342;45.0059;44.6324;45.3772
598348;2361;1148;1213;41.8549;40.9233;42.7366
598356;2373;1189;1184;42.3786;41.5849;43.1757
598364;541;271;270;41.8438;42.2122;41.4741
598399;1432;735;697;42.3527;40.7952;43.9950
552593;780;401;379;40.1436;40.1559;40.1306
512184;1766;871;895;42.6608;41.4575;43.8318
507547;1370;708;662;42.0876;40.6483;43.6269
598445;1222;642;580;42.2430;40.5343;44.1345
598453;3788;1905;1883;42.2503;41.1751;43.3380
554014;3865;1897;1968;41.1582;39.3044;42.9451
552526;288;139;149;40.0451;38.5935;41.3993
552518;1070;525;545;41.4355;40.6752;42.1679
507091;2078;1032;1046;42.9264;40.4622;45.3576
598542;2423;1236;1187;44.5797;43.3050;45.9069
598551;3406;1717;1689;41.2443;40.6549;41.8434
598569;3917;1942;1975;42.2324;41.0875;43.3582
552500;320;159;161;38.3281;37.0975;39.5435
557226;1009;505;504;38.5575;37.5990;39.5179
512028;1863;931;932;40.0518;38.8706;41.2318
568813;916;452;464;43.9771;42.1881;45.7198
507181;1060;576;484;41.9274;42.3594;41.4132
552577;1025;520;505;39.4210;38.0846;40.7970
549665;1928;911;1017;42.4642;40.9094;43.8569
556971;1662;808;854;40.3436;39.4530;41.1862
552640;571;286;285;43.0254;42.5839;43.4684
568830;1869;948;921;41.9682;40.8977;43.0700
598674;1673;859;814;39.3536;38.4662;40.2899
552658;815;431;384;40.4178;38.7274;42.3151
568791;901;438;463;44.8463;43.8333;45.8045
598747;554;290;264;44.5253;42.2276;47.0492
552551;1487;729;758;42.4354;41.6852;43.1570
552569;2217;1102;1115;41.7959;41.2024;42.3825
552674;1056;533;523;40.5672;39.6445;41.5076
569631;2134;1056;1078;40.7127;39.1884;42.2059
552623;1063;530;533;41.0437;39.2604;42.8171
598810;35002;17127;17875;43.5043;41.6508;45.2803
552615;287;142;145;40.0052;39.8944;40.1138
554928;4530;2247;2283;41.5329;40.3229;42.7238
552488;725;363;362;38.3621;38.0868;38.6381
552682;860;450;410;44.5186;43.1756;45.9927
552691;885;441;444;39.6006;38.9444;40.2523
568163;344;164;180;39.5669;39.9451;39.2222
598925;3842;1942;1900;42.8394;41.4676;44.2416
599051;20518;10069;10449;43.4271;41.4901;45.2937
598933;24297;11817;12480;42.8719;41.4264;44.2407
598941;4238;2116;2122;42.8990;41.9731;43.8223
598968;5312;2610;2702;42.6214;41.4762;43.7276
568864;1191;598;593;42.5999;41.6472;43.5607
555088;71200;34646;36554;44.2805;42.2370;46.2173
598178;2441;1193;1248;41.8908;41.3751;42.3838
552739;4411;2253;2158;42.1398;40.5488;43.8007
555291;1390;698;692;39.5295;39.4427;39.6171
598917;52128;25734;26394;44.3811;42.4136;46.2993
599069;28735;14061;14674;42.5095;40.9043;44.0476
599077;5384;2926;2458;44.2400;44.1265;44.3751
599085;7237;3529;3708;42.1671;41.3688;42.9269
599107;7536;3713;3823;42.4963;41.2035;43.7519
599140;1864;953;911;42.2682;41.0677;43.5241
599158;4600;2271;2329;43.5085;42.3917;44.5975
568741;705;349;356;42.6816;40.9585;44.3708
599212;1737;874;863;41.0682;41.1076;41.0284
568481;1000;528;472;40.1890;38.9962;41.5233
546984;585;300;285;40.6179;39.2400;42.0684
599247;7394;3641;3753;42.6442;40.9850;44.2538
554936;458;236;222;43.3930;42.5551;44.2838
568431;614;303;311;41.7557;40.9389;42.5514
556858;973;514;459;38.0755;37.0078;39.2712
599344;10837;5264;5573;43.0944;41.0258;45.0484
599352;5592;2741;2851;42.6849;41.6565;43.6736
568562;338;173;165;37.9053;37.0607;38.7909
568571;166;82;84;43.7048;42.4146;44.9643
569666;997;498;499;41.4358;40.7731;42.0972
599409;1731;853;878;42.8183;41.9185;43.6925
568511;787;393;394;43.0172;41.6934;44.3376
554065;642;320;322;42.5125;41.8813;43.1398
599468;1972;968;1004;41.1435;40.4442;41.8177
599506;1626;822;804;41.1777;39.7543;42.6331
568643;656;317;339;43.1021;40.9164;45.1460
599565;21851;10829;11022;42.4326;40.8238;44.0133
555312;534;274;260;40.9607;40.5766;41.3654
568546;1837;893;944;40.6579;39.5101;41.7436
500046;1710;852;858;41.7444;40.6995;42.7821
599603;1571;820;751;41.6922;40.2317;43.2870
599646;376;188;188;41.6011;42.0106;41.1915
568589;568;279;289;41.7130;41.9659;41.4689
599689;2482;1240;1242;42.9875;41.0056;44.9662
568686;755;386;369;42.0815;40.5829;43.6491
599191;23260;11200;12060;42.6936;40.7738;44.4765
599701;7285;3595;3690;42.0397;40.4327;43.6054
599743;1803;881;922;43.0519;41.9098;44.1432
599808;8476;4155;4321;42.5855;40.8203;44.2829
568775;976;474;502;43.6537;41.3460;45.8327
568554;1252;617;635;41.6573;41.0964;42.2024
599832;1626;783;843;40.2478;40.0479;40.4336
568716;835;406;429;40.3946;40.3227;40.4627
568406;787;400;387;40.3259;39.4075;41.2752
599867;895;459;436;41.9626;40.4891;43.5138
599905;2896;1452;1444;40.8712;39.8629;41.8850
599921;9477;4657;4820;43.4652;42.1405;44.7450
599930;2701;1339;1362;40.7221;39.9884;41.4435
554171;2082;1002;1080;42.4520;41.7814;43.0741
599948;3464;1718;1746;42.9697;41.5215;44.3946
599956;1836;904;932;40.6394;39.5420;41.7039
599964;954;471;483;41.2652;41.6380;40.9017
569755;744;376;368;42.7446;41.1995;44.3234
599999;2697;1365;1332;40.3951;39.5132;41.2988
568422;1153;570;583;40.0577;38.6474;41.4365
500259;1986;998;988;42.3238;41.0772;43.5830
554910;850;443;407;41.1824;39.3984;43.1241
569747;216;109;107;43.7917;45.3624;42.1916
568473;1079;549;530;39.7817;39.0282;40.5623
568732;1092;561;531;39.6740;38.2576;41.1704
547000;661;322;339;40.3850;40.7019;40.0841
512974;661;312;349;43.8086;42.7308;44.7722
506192;1779;883;896;39.5320;38.7197;40.3326
506214;4499;2225;2274;41.6303;40.4339;42.8008
554197;1076;526;550;42.3169;41.1407;43.4418
553107;154;81;73;41.8117;39.6235;44.2397
506320;1495;752;743;42.0873;41.7540;42.4246
506451;1375;708;667;41.2076;40.3023;42.1687
506460;2918;1451;1467;42.7248;40.7516;44.6766
568261;761;370;391;39.9731;38.8892;40.9987
569950;378;198;180;36.7963;36.4091;37.2222
568228;1352;650;702;40.6657;39.3600;41.8746
568236;745;369;376;43.3148;43.5027;43.1303
569895;749;357;392;43.8698;43.1639;44.5128
506702;4038;1980;2058;43.1840;41.5682;44.7386
553051;1045;541;504;43.2675;43.0120;43.5417
506753;3255;1579;1676;44.6616;42.9775;46.2482
568210;2509;1234;1275;42.2350;40.5608;43.8553
553093;668;349;319;38.8024;36.8610;40.9263
568368;570;287;283;41.4333;40.3780;42.5035
507016;13931;6788;7143;43.6210;41.9034;45.2533
507105;1003;498;505;42.6505;41.6566;43.6307
507113;1380;687;693;42.2688;40.7111;43.8131
507261;1182;579;603;46.1650;46.3325;46.0041
507270;5506;2694;2812;42.0349;40.8352;43.1842
512923;1169;562;607;40.8541;39.8043;41.8262
507334;1284;640;644;42.2796;41.2703;43.2826
569909;699;342;357;40.7260;39.6579;41.7493
507377;1055;551;504;42.6242;41.1915;44.1905
547191;244;122;122;41.9303;42.5410;41.3197
507504;3280;1635;1645;41.0787;40.1281;42.0234
547182;1905;928;977;42.6060;41.1972;43.9442
507580;6717;3325;3392;41.8726;40.5541;43.1651
568180;235;126;109;46.6745;44.3730;49.3349
512907;860;434;426;43.5942;42.6521;44.5540
553115;204;107;97;41.1422;38.6776;43.8608
507920;910;468;442;42.4429;39.6560;45.3937
507971;4946;2452;2494;42.8023;40.9462;44.6271
508128;2070;1045;1025;39.8913;38.1785;41.6376
508144;631;335;296;43.6014;42.5149;44.8311
568279;285;150;135;39.1772;37.5067;41.0333
553042;135;72;63;44.6926;43.0694;46.5476
508373;1157;575;582;41.2044;39.6983;42.6924
569097;232;126;106;43.4914;42.9365;44.1509
553158;948;455;493;41.5243;41.1791;41.8428
512893;192;98;94;46.5729;45.7551;47.4255
555274;501;254;247;43.3683;42.9252;43.8239
509574;1410;683;727;40.8752;40.1266;41.5784
505927;56450;27160;29290;43.4447;41.5034;45.2448
509612;1441;701;740;41.1905;40.3288;42.0068
509647;2110;1032;1078;43.1692;42.0814;44.2106
509736;1380;678;702;43.1906;41.4086;44.9117
568317;496;255;241;40.6452;39.4176;41.9440
509841;1148;577;571;40.0671;38.8588;41.2881
568376;591;286;305;41.4966;38.3322;44.4639
510131;1031;516;515;41.5727;40.9496;42.1971
510289;2052;1031;1021;40.5512;37.8948;43.2336
510297;817;395;422;41.2479;40.1152;42.3081
597821;399;198;201;41.5426;41.2172;41.8632
568198;141;77;64;45.7199;45.9156;45.4844
510343;1490;760;730;40.4463;38.7684;42.1932
512869;882;445;437;41.6190;39.8034;43.4680
510378;634;317;317;41.8817;40.6703;43.0931
547131;263;131;132;39.4924;40.7443;38.2500
510432;1612;794;818;42.3381;40.6537;43.9731
568333;672;349;323;41.9122;40.3510;43.5991
510483;3233;1584;1649;40.4289;38.9173;41.8808
510491;1245;607;638;41.5305;39.6054;43.3621
512745;820;383;437;43.8085;42.8029;44.6899
569101;236;128;108;41.2585;39.9922;42.7593
568341;371;182;189;39.9636;39.4286;40.4788
510891;1622;816;806;42.0814;40.7157;43.4640
510939;1843;900;943;41.0931;40.3044;41.8457
570036;743;388;355;43.3345;41.9330;44.8662
511021;5670;2760;2910;43.7586;41.9130;45.5089
511161;514;271;243;41.1401;38.7915;43.7593
568244;1631;783;848;40.3712;39.4272;41.2429
553492;601;289;312;40.1689;38.5796;41.6410
569119;500;247;253;42.2940;39.8563;44.6739
506711;1483;731;752;43.1979;42.2182;44.1503
569500;838;419;419;42.9033;42.7243;43.0823
599549;4495;2206;2289;42.6095;41.3327;43.8399
554049;704;364;340;41.3381;40.4176;42.3235
554821;287968;139824;148144;42.9586;41.1106;44.7027
598739;2822;1399;1423;42.1162;40.5786;43.6279
598798;6393;3143;3250;43.2005;42.1192;44.2462
598836;2036;1016;1020;41.2913;40.8593;41.7216
510882;2071;1008;1063;40.9017;40.0734;41.6872
598879;7293;3549;3744;42.3063;40.8054;43.7289
500291;2918;1448;1470;43.1062;41.8660;44.3279
568449;624;316;308;42.8494;40.8703;44.8799
